#separator:tab
#html:true
象征/体现	国旗是国家的象征<br>國旗係國家嘅象徵<br><br>旗袍能很好地体现中国女性的美<br>長衫可以好好象徵中國女性嘅美麗
项链/頸鏈	我买了一条钻石项链<br>我買咗一條鑽石頸鏈
体会	当了妈妈，我才体会到父母的辛苦<br><br>當咗媽媽，我先體會到父母嘅辛苦
提倡/主张	我哋提倡節約用水。<br><br>主張改革。
斜	这墙有一点倾斜<br><br>斜坡<br>向大財團傾斜
协调/调解	我在想办法协调员工之间的关系。<br>我諗緊辦法協調員工之間嘅關係。<br>眼手協調。<br><br>我尝试调解他们之间的矛盾。<br>調解員。
形成	这个艺术团已经形成了独特的风格<br><br>形成強烈嘅對比
鲜艳	我喜欢色彩鲜艳的衣服<br><br>我鍾意顏色鮮豔嘅衫
液体	水是一种液体<br><br>水係一種液體
移民	越来越多中国人移民到澳大利亚<br><br>越來越多中國人移民到澳洲
性质	这是两种不同性质的犯罪行为<br><br>呢個係兩種唔同性質嘅犯罪行為
相关	我对恐龙相关的书很感兴趣<br><br>我對恐龍相關嘅書好有興趣
调整/调剂/调节	他调整了心情后，重新开始了比赛。<br>佢調整咗心情之後，重新開始咗比賽。<br><br>調節溫度。
虚心	只有虚心学习才能不断进步<br><br>只有虛心學習先至可以不斷進步
因素	造成这个结果的因素有哪些？<br><br>造成呢個結果嘅因素有咩？
学术	他一共发表了5篇學術论文<br><br>佢一共發表咗五篇學術論文
叙述	根据他的叙述，犯人身高约为一米七<br><br>根據佢嘅敘述，犯罪人身高大概一米七
销货/銷量/推销	他上个月的销货成绩非常出色。<br>佢上個月嘅銷量成績非常之出色。<br><br>他很擅长推销自己。<br>做推銷員好頻撲㗎。
意外	意外事故保险<br><br>今次意外死傷好慘烈
以来	三年以来，他从来没有休息过一天<br><br>畢業以嚟，我都冇返過學校
宣传	公司正在大力宣传新产品<br><br>公司大力宣傳緊新產品
选举	通过选举，他成为总统<br><br>舉行總統選舉
因而	他丢了护照因而不能回国<br><br>佢善用民中嘅反戰情緒並因而當選
营业	能告诉我商店的营业时间吗<br><br>假日時間，本店會延長營業時間
延长	医生正在想办法延长他的生命<br><br>假日時間，本店會延長營業時間
硬体/硬件	
宴会	我非常喜欢今晚宴会上的乐队<br><br>今次呢個宴會真係盛大
应付	为了应付老婆，他买了一枚假戒指<br><br>為咗應付額嘅訂單，工人要日以繼夜噉趕工
悠久/持久	中国有着悠久的历史<br><br>一场持久的战役。
义务	赡养老人是我们的义务<br><br>舉報罪行係市民嘅義務
优势/优越	身高优势帮助我们赢得了比赛<br><br>呢個屋邨嘅地理位置優越
优惠［卷過期作廢］	学生可以享受半价优惠<br><br>優惠利率
遺憾	我唔能夠趕返嚟見阿爺最後一面，我覺得好遺憾
与其。。不如。。	與其我去，不如你去
宇宙	宇宙的起源
原料	做这道菜需要一种原料<br><br>小麥係一種原料，麵粉就唔係啦
［綜合］消费［物價指數］	中国游客出国消费的能力非常强。<br><br>今年嘅綜合消費物價指數持續下降。
运输	他买了十辆卡车，成立一家运输公司<br><br>九巴14b同95m拆樓已經得到運輸署支持
运用v/用途n	他运用自己的知识发明好多有用的东西<br>我哋應該好好運用手上嘅人力資源<br><br>这个机器的主要用途是净化空气<br>呢件工具有特定嘅用途
再3（强调）	经理再三强调上班不能迟到<br><br>再三考慮
灾害/灾难	这个地方遭受了今年最为严重的一场灾害。<br>油污引致自然災害。<br><br>一场灾难降临了。<br>面對災難，原來人係咁化學嘅。
询问/征求/咨询	房间里的每个人都受到了警察的询问。<br>佢就呢個工程詢問其他人嘅意見。<br><br>我想征求你的意见。<br>徵求老師嘅同意。<br><br>请问，我想咨询一下怎么申请信用卡。<br>我想諮詢下律師嘅意見先做決定。
摘/指責/责备/责怪	我们去果园帮李大妈摘葡萄。<br>这是这篇文章的摘要。<br>政府指摘傳媒報導失實。<br><br>他毕竟是个孩子，别责备他。
业余	他是一名业余演员<br><br>業餘歌手
黏/粘贴	请把照片粘贴在这里<br><br>黏張海報喺門口<br>喺壁報板上面貼出告示
占线	我给他打电话可是他的电话一直有占线
战争	参加过战争的人都非常热爱和平<br><br>場戰爭終於爆發喇
涨	最近北京的房价又涨了<br><br>物價高漲
招待/接待/做东/召开/主持	妈妈做的好多菜招待客人。<br>特首係禮賓府設宴招待訪港喺國家主席。<br><br>我哋搵間餐廳慶祝一下，我嚟做東。<br><br>據悉特首將會喺稍後召開記者會。<br><br>呢個節目主持好鬼馬，好多觀眾鍾意睇佢。
针对	医生针对他的病情制定了治疗方案<br><br>我哋應該針對呢個問題，對症下藥
娱乐	看书是我的娱乐活动<br><br>我識鬼文學咩？娛樂就識啫
着凉/凍親/冷親/凍到病咗	昨晚着凉了，今天头疼<br><br>夏天去冷氣地方唔著褸好易凍親
（也）照常	星期天他也照常6点起床<br><br>今日巴士照常行駛
诊断（出他的病）	目前，医生还无法诊断出他的病<br><br>經過診斷，佢證實患咗心臟病
缘故	不知道什么缘故，车启动不了了<br><br>佢之所以殺人係有佢嘅緣故
赞成	我不赞成送孩子去国外上学<br><br>我贊成佢嘅睇法
应聘/應徵	他应聘到宁波大学执教<br><br>呢間公司出嘅條件咁吸引，實有好多人去應徵
珍惜	我很珍惜在中国学习的时间<br>呢個機會得嚟不易，你要好好珍惜
实施政策	就项政策能够增加农民的收入<br><br>中國實施一孩政策，所以大部分家庭嘅細路都係獨生子
主观愿望	这是你的一个主观偏见<br>你嘅分析完全冇任何數據支持，太主觀喇
专心	孩子在房间里专心地看书<br><br>專心聽書
状态	据我所知，他目前还是单身状态<br><br>佢而家喺一個極度集中嘅狀態
振动	小鸟振动翅膀<br>佢驚到打冷震
证据	我有他犯罪的证据<br><br>搜集證據
执行/运行	他在执行任务时受伤了。<br>佢決意執行呢個政策。<br><br>列车运行正常。
N志愿者/義工/志工  ADV自愿	现场有好多志愿者帮助游客解决问题。<br>義工不辭勞苦咁幫災民重建家園。<br><br>他自愿把房子赠送给我。<br>我冇迫佢㗎，佢自願留低加班嘅。
中介/代理	中介约了我们明天和房东见面<br><br>地產代理
状况	他的身体状况不允许他去旅行<br><br>法官考慮被告嘅精神狀況之後，決定減刑，由三年改為一年
资格	他没有资格教训我。<br><br>因為冠軍違反參賽條件被取消資格，冠軍位置有亞軍補上。
装饰/布置	快过圣诞节了，人家都忙着装饰圣诞树。<br>呢啲裝飾係用嚟營造歡樂氣氛。<br><br>婚礼那天他负责布置会场。<br>佈置場地。
自觉	上飞机之后大家都自觉地把手机关闭了。<br><br>乳癌初期，因為病徵唔顯著，病人通常都唔自覺自己患病。
支票	你想支票會抵消晒佢啲債<br>唔該兌咗張支票吖<br>我開咗張500蚊嘅支票俾佢
执照	请出示你的营业执照。<br><br>佢嘅駕駛執照俾人吊銷咗。
智慧	以你的智慧，不可能完成不了这个工作。<br><br>大蝦細，無智慧。
至于	我打算暑假去旅行，至于去哪里，目前我还没有决定。<br><br>佢哋唔鍾意對方，但係都不至於要離婚。
周到/體貼	这家餐厅服务周到，深的大家好评。<br><br>佢對男朋友好體貼。
祖国	毕业之后他决定回到祖国工作。<br><br>愛祖國，用國貨。
组合	你可以用这些词组合出一个句子吗？<br><br>呢個組合櫃嘅間隔幾實用。
注册	你必须先用邮箱注册一个帐户。<br><br>註冊網域。
转告	请你转告班长，很感谢他的关心。<br><br>麻煩幫我轉告老師今日有事唔能夠上堂。
作风	办事效率高是他的作风。<br><br>佢管理嘅傲慢作風喺佢對待秘書嘅態度上面表露無遺。
作息	作息不规律容易生病。
做主	这件事我不敢替他做主。<br><br>我作唔到主。
座右铭	我的座右铭是“学无止境”。<br><br>“坐言起行”係我嘅座右銘.
促使	这部电影促使我产生了拍电影的念头。<br><br>今次意外促使政府立法監管建築安全。
分布	藏族分布在中国的西南地区。<br><br>平均分佈。
反复/纷纷	他反复唱一首歌，真烦人。<br>老師話要反覆練習先會有進步。<br><br>下午6点，同事们纷纷下班回家了。<br>市民對今次爆炸事件議論紛紛。
妨碍	你别站在这里，妨碍我。<br><br>你冇權妨礙我嘅人身自由。
仿佛	他特别美丽，仿佛仙女一般。
奋斗	他一直为自己的事业奋斗。<br><br>想晉身奧運需要經過一番奮鬥。
愤怒	他愤怒地摔门走了。
风俗	压岁钱是中国人的一个风俗。<br><br>每個民族都有自己嘅風俗習慣。
殖民地	这里曾经是法国的殖民地。<br><br>喺英國殖民地時代，香港人係由英國人管治嘅。
 指令	请不要随便发指令。
指南针	指南针是中国四大发明之一。<br><br>去行山最好帶埋指南針。
寓言	这个寓言故事告诉我们不能贪图小便宜。<br><br>“狼來了”係家傳戶曉嘅寓言故事。
元素	这套服装用了很多中国的元素。<br><br>元素週期表
原先	原先我打算十一去西藏, 后来我改变了计划。<br><br>我原先話去，而家又唔去。
约束	法律可以约束每个人的行为。<br><br>自我約束。
乐谱/曲譜	孩子已经能按照乐谱演奏了。
岳父	妻子的父亲是岳父。
熨	妈妈正在给爸爸熨衣服。<br><br>件恤衫咁巢，好心就熨下先著啦。
运算	这台计算机的运算能力非常强。<br><br>小學生應該學曬加減乘除四則運算。
孕育	她正在孕育新生命。
酝酿	公司正在酝酿着一场改革。<br><br>一個大陰謀喺度醞釀緊。
杂技	杂技演员可以在钢丝上跳舞。<br><br>有個小丑喺公園耍雜技。
栽培	谢谢你多年的栽培。<br><br>栽培一班新員工。
在乎	我只在乎你。<br><br>我唔在乎人工有幾多，只在乎有冇工作嘅滿足感。
宰	过年时家家户户杀猪宰羊。<br><br>呢間補習社專宰肥羊㗎，乜野都收你錢。
在意	他特别在意别人的评价。<br>佢唔會在意呢啲小事嘅。
再接再厉	请再接再厉，取得更好的成绩。
蕴藏	这里蕴藏着丰富的石油资源。
攒/賺	攒钱
贊助	今晚嘅飲品係由可口可樂公司贊助嘅。
遭受/遭遇/遭殃	近期，我国多省市遭受暴雨洪灾。<br>遭受壓逼。<br><br>他们在回家的中途遭遇歹徒袭击。<br>遭遇不幸。<br><br>如果涨洪水，这片农田就遭殃了。<br>老闆今日心情唔靚，我哋要遭殃囉。
造反	尋晚班士兵突然間造反仲殺咗佢哋個統帥。
造型	这座建筑的造型非常奇特。<br><br>而家中性造型成為一種時尚，好多女仔都剪短頭髮。
噪音	飞机起飞时噪音非常大 。
增添	红色的窗帘为客厅增添了亮色。<br><br>呢場巡遊增添咗唔少節日色彩。
贼	你这是贼喊捉贼。<br><br>三個便衣探員捉咗個賊。
赠送	中国赠送给美国一对大熊猫。<br><br>今期雜誌隨書贈送環保袋呀。
糟蹋(嘥）	请不要糟蹋食物。
渣	这是豆腐渣，不好吃。<br>佢份人唔老實，成日出拿渣。<br>個細佬畀媽咪嬲就發爛渣。<br>我捉棋好渣。<br>啲湯渣好食喎。
扎	紮辮<br>結紮<br>紮實
诈骗	他因为诈骗被捕。<br><br>一單詐騙案。
崭新	新年第一天，他穿了一套崭新的衣服。<br>嶄新設計。<br>嶄新科技。
占据/占领	我们的产品已经占据了大部分海外市场。<br>非法佔據他人財產。<br><br>这款产品已经占领了80%的市场。<br>兩邊都會為咗佔領呢度而不惜一切。
债券	发行债券。<br>今朝呢隻債券嘅價位曾經大幅波動。<br>債券息率介乎二厘至二點五厘。
展望	展望未来，我们信心百倍。
展现	去到唐人街，過年熱鬧嘅氣氛展現眼前。
长辈	對長輩要有禮貌。
沾光/叨光	你升职了，我们跟着沾光。<br><br>如果你贏到呢個比賽，我就可以沾光去慶功啦！
条款	严格履行协定条款。<br>有争议条款。
挑剔/奄尖/揀擇	他对食物非常挑剔。
条理	这故事非常有条理。<br>佢做嘢好有條理。
条约/公約/合約/協約	你违反我们签订的条约，必须赔偿我们。<br><br>我今日上公司簽合約。
挑拨/挑衅	他故意挑拨我和你的关系。<br>挑撥離間。<br>挑撥民族關係。<br><br>我们一定会还击对手的挑衅。<br>提出挑衅性的问题。
赤道	赤道边上的国家一年四季都是夏天。
充沛/充实 > 充足	这里的降水十分充沛。<br>細路仔活力充沛，每日都週圍跑。<br><br>过着充实而有意义的生活。<br><br>这里阳光充足。<br>呢個城市得天獨厚，陽光充足，種出嚟嘅農作物特別好。
绣/编织	我正在绣梅花。<br>佢喺件長衫度刺繡咗條魚仔。<br><br>编织毛衣。
停顿/停滞	这个音符意思就是停顿一拍。<br>對話之間嘅停頓。<br><br>国家的经济停滞不前。
停泊	轮船停泊在港口。<br><br>個海港好大，可以停拍大型郵輪。
同胞	他和小李是同胞兄弟。<br><br>港澳台同胞。
挺拔	道路两旁全是挺拔的松树。
通俗	这篇文章写得非常通俗易懂。<br><br>通俗易明嘅報紙。
通用	这个手机卡全球通用。<br><br>呢兩個字通用㗎。
通货膨胀	通货膨胀导致物价不断上涨。<br><br>通貨膨脹，乜野都話加價，搞到百物騰貴。
统计	根据统计，在地震中有六千人死亡。<br><br>政府會統計每戶嘅精確年均收支。
投机	通过投机，他赚了很多钱。<br><br>投機生意。
瞻仰	我们一起瞻仰庄严的纪念碑。<br><br>瞻仰遺容。
统筹兼顾	国家需要统筹兼顾各个阶层的人民利益。
铜矿	这里有丰富的铜矿资源。
统统	除了王秘书，其他人统统出去。
投票	总统选举的投票已经开始了。<br><br>佢再唔鐘意呢個候選人都好，為咗大局，都要含淚投票支持。
徒弟	他收了三个徒弟。<br><br>佢見到徒弟嘅畫作，覺得自己係時候功成身退。
投掷	他在运动场上练习投掷铅球。
秃	他的头秃了。<br><br>棵樹光禿禿，一塊葉都冇。
途径	这种病毒通过什么途径传播？<br><br>我要通過乜嘢途徑先可以見到佢？
土壤	北方的土壤比南方肥沃。<br><br>岩石同土壤因長年同大氣接觸而分解。
团结	只有团队团结才能不断胜利。<br><br>團結一致對抗敵人。
团体	双方由民间团体出面商谈贸易。<br><br>akb48係日本人氣偶像團體。
涂抹	孩子喜欢在画板上涂抹各种颜色。<br><br>你成日流鼻水唔抹，好鬼核突㗎你知唔知呀。
團圓	因為打仗佢哋幾十年冇曬對方消息，今日終於可以團圓。
推测/推论/推理	我推测他明天不会来。<br>政府根據一啲數據嚟推測來年嘅經濟增長。<br><br>合乎逻辑的推论。<br>陳教授將我嘅推輪引申到更加高嘅層次。<br><br>这样推理很周全，却说服不了我。<br>呢本推理小說嘅結果喺意料之外，但係又喺情理之中。
推翻	最后，这个王朝的统治被推翻。<br><br>警察終於倒戈加入示威者，推翻無理嘅獨裁者。
脱离	他和他的父亲脱离了关系。<br><br>愛爾蘭喺1922年宣佈獨立，脫離英國嘅統治。
吞咽	这菜难吃得无法吞咽。<br><br>吞曬啲藥佢啦！
拖延	他办事非常拖延。<br><br>你唔好再喺度拖延時間喇！
妥当	他办事很妥当,你放心吧。<br><br>處理得好妥當。
托运	我已经把行李托运了。
妥善	假期前请大家妥善安排好自己的工作。
妥协	最后我向他妥协了。<br><br>發言人重申佢哋絕不向恐怖分子妥協。
椭圆/长圆/卵形/鴨蛋形/鵝春形/鵝蛋形	
崇拜	盲目崇拜<br>偶像崇拜
喘气	他累得一直在喘气。<br><br>你畀我喘下氣得唔得？
抽空	请抽空回覆这封邮件。<br><br>多謝你抽空嚟睇我嘅表演。
重叠	精简重叠的行政机构。<br><br>政府架構重疊，浪費好多資源。
出路	投降是你唯一的出路。<br><br>而家嘅大學生都好擔心自己嘅出路。
稠密	这个小孙子很人烟稠密。
出身	佢出身卑微。<br>佢做廚師出身嘅。
丑恶	我厌恶他丑恶的嘴脸。<br><br>極醜惡。
出神	他对着窗户出神。<br><br>佢嘅廚藝已經達到出神入化嘅境界。
处境	呢個處境好尷尬。
迟疑	他毫不迟疑地拒绝了采访。<br><br>你遲疑不決噉，幾時先做到決定？
传达	我已经向同事传达了经理的意思。<br><br>阿明用短信向阿娜傳達愛意。
慈祥	個老伯好慈祥。
处置	你打算怎么处置这个叛徒？<br><br>我哋點處置呢個反骨仔好？
雌雄	我和他终于可以通过比赛一决雌雄。
次序	请你按次序上车。<br><br>我跟日期排好曬啲相，你唔好搞亂個次序呀。
粗鲁	那个服务员的态度特别粗鲁。<br><br>乜你咁粗魯㗎，一坐低就棟高隻腳。
摧残	不按时吃饭就是在摧残身体。
搓	佢俾條女搓圓㩒扁都冇投訴, 睇嚟佢地應該打風都打唔甩。
不禁	冷风一吹，我不禁打了个喷嚏。<br><br>雖然佢係我好朋友, 但我都係不禁暗自慶幸, 佢呢家重病, 冇人同我爭做主角。
辩护	他聘请了最好的律师为他进行了辩护。<br><br>佢為自己所做嘅壞事辯護。
冰雹	香港處於亞熱帶嘅南部, 所以好少會落冰雹。
剥削	剥靴门觉得被老板剥削了。<br><br>記者潛入工廠調查工人被剝削嘅情況。
裁判	这位裁判的判决不公正。
部署	请你开始部署下一步的行动。<br><br>我哋唔可以畀佢打亂部署，唔係就會前功盡廢。
偿还	我已经传还完所有的贷款。<br><br>清還債務。
測量	高血壓病人要定期測量血压。<br><br>貓鬚能夠測量障礙物有幾高，幾闊。
倡议	公司倡议积极为灾区捐款捐物。<br><br>佢哋嘅爭拗各有各道理，最後由老細打圓場，話兩個人嘅提議都會試下。
查获	查获一名间谍。<br><br>警方搗破犯毒集團倉庫, 查獲大批可卡因。
澄清	他向媒体澄清了事实。<br><br>特首辭職嘅謠言傳出之後, 特首一直未有露面澄清。
储备	适当地储备人才。<br><br>政府將會調動緊急儲備應付金融危機。
船舶	港口停泊着很多船舶。
垂直	旗杆垂直于地面。
纯洁	白色象征着纯洁。<br><br>純潔嘅靈魂。
传授	爸爸把这个手艺传授给了我。<br><br>我已經將我所識嘅嘢全部傳授咗俾你。
伺候	她老公每天都把她伺候得非常舒服。
节奏	这首曲子的节奏非常欢快。
解除	董事长解除了他的职务。<br>解除合同<br>解除禁令<br>解除婚约
经费	经费缺口<br>行政经费<br>节减经费<br>经费充足<br>拨付/报领经费<br>编列的教育经费<br><br>研究經費<br>中心因為經費不足, 下個月開始會停止運作。
解雇	对不起，你被解雇了。<br><br>解雇預員工。
借鉴/借鏡	我們需要善于借鑒國外的成功經驗。<br><br>借古鑑今。
提倡/主张/倡导	我哋提倡節約用水。<br><br>主張改革。
借助	我可以借助詞典閱讀中文報紙。<br><br>借助佢嘅財勢。
紧密	香港和大陸的商業聯系越來越緊密。<br><br>要解決呢個長期存在嘅問題, 我哋一定要緊密合作。
紧迫	时间越来越紧迫。<br><br>形势很紧迫。
进攻	在籃球比賽中，進攻和防守都很重要。
进展	妳最近的工作進展如何？<br><br>冇乜進展。<br>件事進展成點？
竞选	竞选总统。<br><br>竞选连任。
酒精	用酒精消毒。<br>呢杯飲品嘅酒精含量好低。
触犯	你的行为触犯了法律。
精简	公司正在精简人员。<br>精簡行政架構。
精密	相機制造需要非常精密的儀器。<br><br>精密嘅計算。
惊奇	讲了令人惊奇的故事。<br><br>你平時成日都唔温書, 我好驚奇你入到大學。
精确	經過精確的計算，衛星進入了軌道。<br><br>精確嘅人口統計。
纯粹	和他聊天純粹是浪費时间。<br><br>呢啲消息純粹係訛傳。
精通	他精通五种语言。<br><br>而家啲細路好多才多藝㗎, 又識拉小提琴, 又識跳芭蕾舞, 仲精通兩文三語, 問你死未。  
精心	精心策劃的陰謀。<br><br>精心炮制。
精益求精	他对工作精益求精。
戒备	戒备森严。<br><br>政府對呢個病提高戒備。
精致	这家餐厅的菜品不仅美味，而且非常精致，让人赏心悦目。<br><br>呢個蛋糕好精緻，一定係出自名師之手。
履行	我承诺过要履行我的责任。<br><br>我哋要履行自己嘅承諾。
搂	她搂着她的宠物猫，低声地说，“你真是太可爱了。”<br><br>我哋兩個好朋友，我哋會搂住對方。
茫然	他站在十字路口，茫然地看着来来往往的人群，不知道该往哪里走。<br><br>佢聽到呢個消息之後就呆咗，茫然唔知點算。
搏斗	两只狮子在沙漠中搏斗，争夺着仅有的一块水源。<br><br>佢哋兩兄弟成日為咗啲小事就喺屋企搏鬥，搞到阿媽都頭痛
笨拙	他笨拙地试图用筷子夹起一块豆腐。<br><br>佢做嘢成日咁笨拙，攞個杯都會跌親。
不择手段	为了赢这场比赛，他甚至不择手段，使用了一些违反规则的战术。<br><br>佢為咗升職真係乜嘢衰嘢都做得出
缠绕	藤蔓缠绕着古老的树干，形成了一幅美丽的图案。<br><br>啲電線纏繞喺條柱度好難整
境界	他的书法已经达到了炉火纯青的境界。<br><br>你睇佢打功夫打到咁勁，真係去到另一個層次喇
颈椎	长期伏案工作容易导致颈椎疼痛。<br><br>我呢排成日訓到頸椎痛，實在要去睇骨醫生。
浸泡	为了去除泥土，我把蔬菜浸泡在清水里。<br><br>啲白鐘豆要浸泡成晚先至煮得
补偿	公司承诺会对因罢工造成的损失进行补偿。<br><br>間公司整爛咗我部電話，要賠五千蚊畀我做補償。
镜头	导演要求摄影师调整镜头的角度，以便更好地捕捉演员的表演。<br><br>你嗰部相機個鏡頭好似有啲花咗喎
诚挚	他对朋友表达了诚挚的歉意。<br><br>佢對人嘅態度真係好真誠
场合	这个场合不适合谈论政治。<br><br>去婚宴呢啲場合，梗係要着套西裝啦。
就业	大学毕业后，他找到了一个不错的工作，顺利就业了。<br><br>佢呢排搵到份工返
就职	他将在下个月正式就職为公司新总裁。<br><br>聽講佢聽日就到職喇，做嗰間公司嘅人力資源部主管。
解剖	生物课上，老师会带领我们解剖青蛙。<br><br>醫生要解剖具屍體先至搵到死因
鞠躬	在颁奖典礼上，她鞠躬感谢了所有支持她的人。<br><br>我哋向阿婆拜咗三拜
拘束	在正式场合，我总是感到拘束。<br><br>你咁拘束做咩啫，放鬆啲啦！
局部	这座雕像的局部细节非常精细，令人叹为观止。<br><br>呢間商場而家淨係得一部份嘅舖頭開門
拘留	警方以涉嫌盗窃罪将嫌疑人拘留。<br><br>警察將佢拉咗去扣留二十四個鐘頭
局限	由于资金的局限，我们只能进行小型项目。<br><br>呢個計劃局限咗我哋嘅發展空間
举动	他的举动引起了大家的注意。<br><br>佢嘅舉動好奇怪，成日都喺度自言自語。
磋商	中美双方就贸易问题进行了数月的磋商。<br><br>我哋而家傾下點樣合作啦。
搭配	这件衬衫搭配那条裙子很漂亮。<br><br>你今日著嘅衫褲配搭幾好睇㗎喎。
达成	经过几轮的谈判，双方终于达成了协议。<br><br>經過成個月嘅傾談，雙方終於達成共識。
打官司	他们为了争夺遗产打了一场冗长的官司。<br><br>佢同隔離鄰居因為噪音問題打官司，搞到雙方都頭崩額裂。
打击	这次考试的成绩对他的自信心造成了很大的打击。<br><br>政府要加大力度打擊黑市貨品
打猎	我们一起去森林里打猎，寻找野生动物的踪迹。<br><br>佢哋一班人周末都會去打獵，專登搵啲偏僻啲嘅地方
凑合	虽然这酒店条件一般，但凑合着住一晚还是可以的。<br><br>冇辦法喇，而家暫時湊合住先啦。
猖狂	敌人已经变得越来越猖狂，我们必须团结一致抵御他们。<br><br>呢排啲賊咁猖狂，連警署隔離都敢偷嘢。
沉闷	这间教室里的气氛太沉闷了，我几乎要打瞌睡了。<br><br>呢間餐廳冇乜嘢特別，坐低冇耐就覺得好悶
承包	这家公司承包了修建高速公路的工程。<br><br>佢哋公司承包咗成個地鐵站嘅裝修工程
储蓄	为了将来买房，她每个月都坚持储蓄一部分工资。<br><br>我每個月都會擺啲人工入儲蓄戶口度。
传单	超市门口摆满了促销商品的传单。<br><br>有個後生仔喺街口派緊傳單俾路過嘅人
颤抖	他的双手因为寒冷而颤抖。<br><br>佢驚到全身都震晒
大体	这部电影大体上还不错，但结尾有点仓促。<br><br>大體上嚟講呢個方案都幾好嘅。
大意	他因为大意，错过了重要的会议。<br><br>本書睇完大意就係講一個後生仔點樣喺鄉下生活
大致	这座城市的大致人口约为 100 万。<br><br>大致上佢朝早九點幾就會返到公司㗎喇
逮捕	警方因涉嫌盗窃而逮捕了嫌疑人。<br><br>警察喺街市度拉咗個賊仔。
代价	为了获得成功，他们付出了巨大的代价。<br><br>做咩都要畀代價㗎，你唔好以為咁易冇事。
贷款	为了购买新房，他们向银行申请了一笔贷款。<br><br>我琴日去銀行借咗筆錢買樓
代理	这家公司是很多品牌的代理商，负责销售其产品。<br><br>我而家做緊呢間地產代理，主要幫人睇樓同租樓。
带领	他带领着团队取得了重大胜利。<br><br>佢帶領啲新同事參觀公司設施
怠慢	我们不能怠慢顾客，因为他们的满意度是我们的首要任务。<br><br>你唔好成日咁偷懶，要認真啲做嘢先得㗎。
淡季	淡季的时候，旅行社的价格通常会比较便宜。<br><br>而家係淡季，個飛平咗好多喎。
诞生	中国共产党于1921年7月诞生于上海。<br><br>佢係喺香港出世㗎
胆怯	面对着如此大的挑战，他并没有胆怯，反而表现出了极大的勇气。<br><br>佢咁細個就要上台表演，梗係會提唔起勇氣啦。
淡水	淡水湖泊里的鱼类品种繁多。<br><br>呢啲淡水魚一定要養喺淡水先至生存到㗎。
当初	当初，我想去学医，可是后来改变主意了。<br><br>當初我以為呢份工好容易做，點知原來咁多嘢要諗
当前	当前的经济形势并不乐观。<br><br>而家我哋公司有二十個員工做緊嘢。
当事人	警方已经找到了所有与案件相关的当事人。<br><br>警察問咗所有當事人先至知道件事嘅來龍去脈
当务之急	现在当务之急是找到丢失的钥匙。<br><br>而家香港樓價咁貴，幫市民解決住屋問題係最緊急嘅事
档案	公安局的档案室存放着许多重要文件。<br><br>呢個檔案有啲大，可能要壓縮一下先至傳得去
导弹	敌方发射了多枚导弹攻击目标。<br><br>聽講北韓又試咗支新導彈出嚟
导航	打开手机导航，我就能找到去那家餐馆的路了。<br><br>部電話冇咗 GPS 導航真係好難搵路
导向	这篇文章的目的是导向一个新的解决方案。<br><br>我哋要幫新嘅同事指引正確嘅工作方向
承办	这家公司承办了这次重要的国际会议。<br><br>呢間旅行社承辦晒啲內地嚟香港嘅團
出洋相	在重要会议上出洋相，真是丢人又尴尬。<br><br>你咁大聲話人哋講錯，點知自己都唔識，真係出晒洋相囉。
津津有味	他津津有味地听着朋友讲述他的旅行故事。<br><br>佢食早餐食到津津有味，連埋啲包都唔想剩低。
近来	近来，他一直在学习中文，进步很大。<br><br>最近我搵到份好工開心到飛起
精打细算	为了节省开支，我们不得不精打细算，避免浪费。<br><br>啲細路咁大個都要教佢哋精打細算，唔好亂咁使錢。
踌躇	他站在十字路口，踌躇不决，不知道该往哪个方向走。<br><br>你做嘢咁猶豫不決，點樣做到嘢啫？
媒介	互联网成为了现代社会传播信息的重要媒介。<br><br>而家啲傳媒成日都會報導疫情嘅最新消息。
奖赏	为了鼓励孩子勤奋学习，父母决定给他一个丰厚的奖赏。<br><br>做得好嘅員工，公司梗係會獎賞佢㗎啦。
警惕	他时刻保持警惕，以防意外发生。<br><br>最近成條街都咁多賊仔，大家都要提高警覺啲。
救济	政府为灾区人民提供救济物资，包括食物、水和衣物。<br><br>政府每個月都會俾救濟金幫啲窮人渡過難關。
得罪	他总是爱说一些得罪人的话，所以朋友越来越少。<br><br>你咁樣講嘢好容易得罪人㗎喎。
登录	为了访问网站，请先登录你的账户。<br><br>我個電腦登錄唔到，可能要叫IT部門幫手睇下
登陆	为了获得最佳的游戏体验，请您先登陆游戏账号。<br><br>阿波羅號成功登陸月球表面
等级	根据你考试成绩的等级，你可以选择更高级别的课程。<br><br>呢間餐廳嘅服務好普通，得三粒星嘅評級。
岛屿	这个岛屿以其美丽的海滩和原始的自然风光而闻名。<br><br>我哋香港啲離島好多都係冇人住嘅
得不偿失	为了省下那一点钱，他们选择了二手货，结果用不到一年就坏掉了，真是得不偿失。<br><br>咁樣做真係得不償失，賺到嗰啲錢都唔夠彌補損失添。
瞪	他瞪着眼睛，似乎很不高兴。<br><br>佢成日都咁樣瞪大對眼望住我，搞到我好唔自在。
档次	这家餐厅的档次很高，价格也相应地贵一些。<br><br>呢間餐廳嘅檔次幾高㗎，我哋著靚啲先好去。
盗窃	这家商店昨晚发生了一起盗窃案，警方正在追查嫌犯。<br><br>班賊仔成日喺商場偷嘢，俾警察拉咗。
敌视	他们之间充满了敌视，无法正常交流。<br><br>佢哋好似敵人咁樣對待新嚟嘅同事
歹徒	歹徒被警察逮捕后，终于承认了犯罪事实。<br><br>啲殘忍嘅兇徒喺銀行度打劫，仲傷咗個保安。
抵抗	面对侵略者，我们要坚决抵抗。<br><br>我哋唔可以坐以待斃，一定要抵抗到底！
雕塑	博物馆里收藏着许多古代的雕塑作品。<br><br>呢個人像擺喺公園度睇落幾靚下
典礼	学校举行了一场简短的典礼来庆祝新学期的开始。<br><br>今朝我去咗個畢業典禮，睇住啲學生攞畢業證書好感動。
典型	他是一个典型的中国农民，勤劳朴实，热爱生活。<br><br>呢間燒味鋪係一個典型嘅街坊小店
兢兢业业	他兢兢业业地工作了十几年，终于取得了成功。<br><br>佢做嘢好盡力㗎，成日都早返夜收，冇偷懶過。
点缀	夜空中点点繁星点缀着深邃的夜幕。<br><br>佢喺個客廳度掛咗幾幅畫做點綴
垫	我垫了厚厚的毛毯在床垫上。<br><br>你唔好直接擺個熱杯喺檯面度，記住要用個杯墊呀。
堤坝	长江的堤坝修得非常牢固，可以抵御洪水。<br><br>呢條堤壩可以防止水浸同埋儲水發電㗎。
抵达	我们已经抵达目的地了，可以下车了。<br><br>我哋落機之後去到酒店已經係夜晚十點幾
电源	手机没电了，请帮我找一下电源插座。<br><br>我部電腦嘅電源線跣咗，要買過條新嘅。
地势	这座城市的地理位置优越，地势平坦，非常适合居住。<br><br>呢度周圍啲地形都好平坦
叼	这只小狗喜欢叼着它的玩具到处跑。<br><br>你個狗咁惡㗎，會咬人嘅！
盯	他一直盯着那幅画，似乎想从中发现什么秘密。<br><br>你唔好成日盯住部電話睇啦，對眼會壞㗎。
定期	我们公司会定期举行员工培训。<br><br>我哋公司每個月都要開定期會議傾下啲工作進度。
递增	随着年龄的增长，他对古典音乐的兴趣呈现递增趋势。<br><br>啲樓價由年頭到而家慢慢升上嚟
定义	这部字典对“幸福”的定义非常深刻。<br><br>你要點樣解釋「愛」呢個字嘅意思先？
颠簸	乘坐火车经过山区时，道路非常颠簸。<br><br>架車咁上下郁，大家記住扶實扶手啊！
颠倒	你把日期颠倒了。<br><br>佢成日都顛倒是非，講啲嘢完全冇分對錯
独裁	这个国家长期处于独裁统治之下。<br><br>佢做班長嗰陣成日要所有人都順從佢一個人嘅意願
调动	公司决定调动部门经理，让他去负责新的项目。<br><br>我哋要將下個月嘅人手調動一下，等啲同事輪流去做唔同嘅工作。
惦记	我一直惦记着明天要交的报告。<br><br>阿媽出咗街都仲係掛住我食咗飯未
董事长	董事长宣布了公司的新战略。<br><br>聽講佢而家喺間公司做緊最高執行人，成日都要開會。
动机	他盗窃的动机是为了钱。<br><br>佢做嗰啲嘢背後嘅動機其實好單純，就係想幫人
冻结	由于经济危机，公司不得不冻结所有员工的工资。<br><br>政府宣布凍結今年嘅學費加價
动静	深夜里，屋外一点动静都没有，只有风吹树叶的声音。<br><br>你聽到隔離單位有咩動靜未呀？
动态	社交媒体上充斥着各种各样的动态，让人应接不暇。<br><br>呢個情況成日都變來變去，真係好難預計。
动脉	心脏病患者需要格外注意控制自己的血压和动脉健康。<br><br>我阿爺今日驗血壓，醫生話佢條動脈有啲問題。
斗争	为了维护自己的权益，他们决心与不公正的制度斗争到底。<br><br>佢哋兩個成日為咗啲小事鬥來鬥去，搞到大家都好煩。
都市	这座都市充满了活力，吸引着来自世界各地的游客。<br><br>香港依家已經變咗一個好繁榮嘅大城市。
兜	他把零钱都兜在口袋里。<br><br>你揾個兜裝啲零食啦，唔好亂咁放喺枱面。
奠定	他的努力和付出为公司的成功奠定了坚实的基础。<br><br>我哋要做好基本功，先可以打好個基礎
抵制	消费者应该抵制价格过高的产品。<br><br>我哋一齊杯葛呢間公司先至會令佢醒啦！
堵塞	高速公路上的事故导致了严重的路段堵塞。<br><br>呢條街好多車，成日都阻塞到死
叮嘱	出门前，妈妈千叮咛万嘱咐，让我在外要小心谨慎。<br><br>阿媽臨出門前叮囑我記得收衫。
杜绝	为了杜绝安全隐患，工厂加强了安全生产培训。<br><br>我哋要諗辦法徹底剷除呢個問題
端正	他端正了一下坐姿，认真地听老师讲课。<br><br>佢個樣生得好端正，好靚仔嚟㗎。
短促	这首歌的旋律短促而动听。<br><br>呢個活動咁短促，都未玩夠就要收咗檔。
动荡	全球经济动荡不安，投资变得更加谨慎。<br><br>呢排香港咁唔安穩，啲生意做到好艱難
动身	我们明天早上动身去旅行。<br><br>我哋五點鐘就要出發㗎喇，快啲執好行李啦。
断断续续	由于信号不好，我们的通话断断续续的。<br><br>佢個電話線壞咗，打嚟打去都係斷斷續續聽到啲說話。
对策	面对经济危机，公司需要制定有效的对策。<br><br>我哋要諗個好啲嘅方法去處理呢件事
动员	老师在课堂上动员大家积极参与讨论。<br><br>全班同學一齊動員幫手執拾課室。
对称	这座花园的设计非常对称，两边都种着一样的花卉和树木。<br><br>呢幅畫嘅左右兩邊完全一樣，好靚㗎
对立	两党之间的对立加剧了社会的分裂。<br><br>兩個人成日都咁對立，點樣可以一齊做嘢啫？
兑现	他承诺的诺言最终还是没有兑现。<br><br>佢終於將承諾實現出嚟啦
恶心	看到他那副嘴脸，我感到一阵恶心。<br><br>呢隻蟑螂咁噁心，我見到都想嘔。
断绝	由于沟通不良，两国之间的外交关系已经断绝。<br><br>佢哋兩個嘈完交之後就絕交㗎喇，到而家都仲係零交流。
堆积	书桌上堆积着各种文件和资料。<br><br>啲舊報紙堆積咗喺梳化後面，實在太亂啦。
对抗	在漫长的历史中，人们一直在对抗各种各样的挑战。<br><br>啲學生同老師對抗，成日都唔交功課。
对应	每个单词都对应一个汉语拼音。<br><br>呢個方案應該點樣對應番市民嘅需求呢？
哆嗦	天气寒冷，我的手都开始哆嗦了。<br><br>凍到成個人掹掹震
断定	经过仔细调查，警察断定凶手就是他。<br><br>我哋而家得到咁少資料，仲未可以斷定發生咩事
遏制	政府正在努力遏制物价上涨。<br><br>我哋要即刻遏止呢個問題擴大
二氧化碳	植物通过光合作用吸收二氧化碳，释放氧气。<br><br>呢排環保署成日話要減少二氧化碳排放，唔係嘅話會加劇溫室效應。
发觉	我发觉他最近经常心事重重，不知道发生了什么。<br><br>我琴日先發現佢原來唔係咁諗嘅
发誓	她发誓永远不会再犯同样的错误。<br><br>我發誓以後會認真讀書㗎喇
发扬	我们应该发扬中华民族的优秀传统文化。<br><br>我哋要發揚呢個好傳統落去
法人	这家公司是一家由法国人和中国人共同创立的法人工司。<br><br>呢間公司係一個註冊咗嘅法人團體
反动	革命者们指责政府的反动政策。<br><br>呢啲人咁保守，成日反對任何改變，真係好麻煩。
反抗	面对压迫，人民选择团结一致，反抗暴政。<br><br>阿仔成日都反抗我講嘅嘢，搞到我好頭痛
反问	面对老师的批评，学生大胆地反问了几个问题。<br><br>你話我唔識做？咁你識做咩？
防疫	为了防止疫情蔓延，政府采取了严格的防疫措施。<br><br>最近流感高峰期，記得要勤洗手預防病毒傳播。
防御	为了防御敌人的进攻，他们建立了坚固的城墙。<br><br>我哋要做好防禦工夫，唔好畀人有機會偷襲。
防止	为了防止意外，请务必系好安全带。<br><br>要搞掂啲老鼠，我哋要搵滅蟲公司嚟幫手
防守	球队在最后时刻加强防守，成功守住了胜局。<br><br>你踢波嗰陣唔好淨係顧住防守，都要識得進攻
防治	政府正在积极采取措施防治环境污染。<br><br>要喺夏天嚟之前做好防蚊嘅準備，咪俾蚊虫滋生囉。
放射	核电站会释放放射性物质，对环境造成严重影响。<br><br>呢間醫院啲放射治療設備好先進㗎
飞翔	在蔚蓝的天空中，一群候鸟自由地飞翔。<br><br>睇吖，個老鷹喺天空度自由自在咁飛緊。
飞跃	运动员在比赛中展现出了惊人的飞跃，令人叹为观止。<br><br>今年公司生意好好，利潤升幅特別大
废墟	地震过后，城市中心变成了废墟。<br><br>經過咁多年都冇人住嘅地方，依家變晒廢墟。
废除	中国在20世纪70年代废除了计划生育政策。<br><br>政府話要廢除呢條咁過時嘅法例喇
外表	他虽然外表看起来很凶，但内心却十分善良。<br><br>佢個樣好靚，不過性格就冇咁好。
外界	外界对这场比赛的关注度很高。<br><br>好多人都唔知我哋公司嘅內部運作，外界淨係見到啲表面嘢。
网络	网络上有很多关于旅行的资讯。<br><br>我哋學校個網路好快，上網睇片都唔會卡住。
唾沫	他忍不住唾沫横飞地讲述着自己的经历。<br><br>佢講嘢嘅時候成日噴口水出嚟。
外行	我在这方面是个外行，所以我需要你的专业指导。<br><br>我睇你咁嘅做法就知你係個外行人嚟㗎喇。
章程	我们必须严格遵守公司的章程，以确保业务的顺利进行。<br><br>你睇吓個報名章程先啦，裏面寫晒啲詳細資料。
瓦解	敌人内部的矛盾导致了他们军队的瓦解。<br><br>呢間公司冇咗老闆支持之後好快就瓦解咗。
战役	这场战役对整个国家都产生了重大影响。<br><br>呢場仗打到死去活來，雙方都損失慘重。
歪曲	媒体歪曲了事实，引起了公众的愤怒。<br><br>佢成日都咁鍾意歪曲人哋講嘅嘢，搞到大家都好反感。
完备	这份报告的论据完备，逻辑严密，令人信服。<br><br>呢間酒店啲設施真係乜嘢都有，由游水池到健身室樣樣齊。
完毕	我完成了一个月的旅行，现在终于回到了家。<br><br>啲嘉賓走晒之後，我哋就可以收拾個場
顽固	尽管医生苦口婆心地劝告，他依然顽固地坚持自己的饮食习惯。<br><br>佢真係好頑固，講咩都唔肯改變主意。
顽强	尽管遭遇了巨大的困难，她依然顽强地坚持着自己的梦想。<br><br>佢練習嘅精神真係好頑強，每日都咁早起身去跑步。
挽回	虽然已经发生了很多不好的事情，但我们仍然有机会挽回局面。<br><br>唔好再嘗試挽回啦，佢已經決定咗要分手。
万分	她万分感谢大家的帮助。<br><br>你幫咗我咁多，我真係萬分感激！
往常	往常，她每天早上都去公园跑步，但今天她因为生病而没去。<br><br>平時我哋都係咁樣做㗎啦。
惋惜	我们对她的离职表示惋惜。<br><br>睇住佢咁後生就走咗，真係好可惜。
微不足道	这只是一点小事，微不足道。<br><br>你俾嘅錢太微不足道，根本唔夠交租。
威风	将军威风凛凛地站在队伍的最前面，手持宝剑，指点江山。<br><br>睇吓個差佬咁有型，行路都好威風
微观	在微观世界中，细菌以令人难以置信的速度繁殖。<br><br>要了解依個問題，我哋要用好細微嘅角度去睇先得㗎。
妄想	他妄想一夜暴富，却忽略了现实的残酷。<br><br>你咁樣諗埋晒啲無可能嘅嘢，都係白費心機啫。
威力	新型冠状病毒的威力不可小觑。<br><br>架直升機嘅引擎威力好大，起飛嗰陣成個地下都震埋
威信	这家公司的领导威信很高，员工们都很信服他。<br><br>而家啲人成日用微訊傾偈，連阿婆都學識用添。
维持	为了维持社会秩序，警察会严格执法。<br><br>我哋要維持依家嘅生活水平先得
唯独	他什么都不怕，唯独怕黑暗。<br><br>佢哋全部人都去旅行，得我一個要留喺度
为难	我不想为难他，所以没有提出我的要求。<br><br>你咁樣做法真係好為難人喎
为期	为期一个月的培训即将结束。<br><br>呢個課程要用兩個月時間
挽救	医生尽力挽救了那个病人的生命。<br><br>我哋要諗辦法挽救呢間公司，唔可以就咁俾佢倒閉。
维修	我的汽车需要维修，所以我去修理店把它送去了。<br><br>部電腦死機成日，要搵人嚟整先得
伪造	他们试图伪造这幅名画以获取巨额利益。<br><br>啲騙徒扮咗張銀行單據嚟呃錢。
委员	这位委员在会议上发表了重要的意见。<br><br>我哋班委員每個星期都要開兩次會
胃口	今天天气太热了，我完全没有胃口吃饭。<br><br>佢今朝發燒，連早餐都冇胃口食
障碍	他克服了重重障碍，最终取得了成功。<br><br>呢排喺路度整緊嘢，好多障礙物擺咗喺度，行路都要好小心
需求	由于市场需求旺盛，这家公司的产品供不应求。<br><br>而家樓價咁貴，市場需求都慢慢減少緊
虚荣	他为了满足虚荣心，经常炫耀自己的财富。<br><br>佢咁貪慕虛榮，成日都要買名牌嘢著
须知	在办理签证之前，请务必仔细阅读须知。<br><br>記住睇清楚呢度貼咗啲乜嘢注意事項先至入去啦
许可	经理没有许可我提前离开办公室。<br><br>你要攞到政府批准先可以開舖頭
畜牧	中国北方地区以畜牧业为主。<br><br>佢屋企喺新界養咗好多雞同豬，做緊農場嘅生意。
序言	这本书的序言阐述了作者创作这本书的背景和目的。<br><br>篇文嘅開頭寫得幾好，等讀者一睇就明白成篇講咩。
宣誓	他宣誓永远忠诚于国家。<br><br>新嘅議員今日喺立法會監誓
宣扬	这家公司宣扬他们对环保的承诺。<br><br>佢成日都四圍揚開啲八卦嘢俾人聽
酗酒	他长期酗酒，导致身体状况越来越差。<br><br>佢飲酒飲到上癮，日日都醉醺醺咁返屋企
悬挂	国旗悬挂在高高的旗杆上。<br><br>天文台而家懸掛三號風球
旋律	这首歌曲的旋律非常优美，让人听了很舒服。<br><br>呢首歌嘅旋律幾好聽，我成日都喺度哼
悬念	电影的结尾留下了悬念，让观众意犹未尽。<br><br>我睇呢齣劇集睇到冇晒胃口，好想知道個結局會點。
威望	他是一位在业界拥有很高威望的专家。<br><br>佢係我哋公司最有威望嘅高層，連董事長都要聽佢講嘢。
违背	他违背了诺言，让朋友们很失望。<br><br>佢咁樣做係唔遵守一開始應承過我哋嘅嘢
为首	以李华为首的团队成功完成了项目。<br><br>呢個黑社會集團係以佢做大佬㗎
畏惧	面对困难，我们不应该畏惧，而应该迎难而上。<br><br>佢由細到大都好驚蟑螂，見到就企埋一二邊度震
未免	他这次考试成绩不太理想，未免有些沮丧。<br><br>你咁講未免太過分喇
慰问	领导亲自前往灾区慰问受灾群众。<br><br>聽到你阿媽入咗醫院，我哋今晚去探下佢，慰問下佢啦。
位于	这座历史悠久的寺庙位于山顶，俯瞰着整个城市。<br><br>間餐廳就喺地鐵站隔離
温带	中国大部分地区属于温带气候。<br><br>香港唔係溫帶地區，所以我哋冇咩機會見到四季分明嘅景色。
温和	尽管他表达了自己的不满，但他用温和的语气，避免了争吵。<br><br>佢啲講嘢方式好温和，唔會令人覺得有壓力。
文凭	他靠着多年的努力终于拿到了大学文凭。<br><br>佢琴日先至攞到張文憑，開心到跳起上黎
文物	这座博物馆收藏了大量珍贵的古代文物。<br><br>啲文物展覽嘅嘢咁值錢，我都唔敢亂摸。
悬崖峭壁	山路崎岖，一路都是悬崖峭壁，令人胆战心惊。<br><br>呢度啲山邊咁陡峭，一唔小心跌落去就死㗎喇！
选拔	为了参加奥运会，国家队将会进行严格的选拔。<br><br>我哋公司最近搵緊人，想喺好多申請者入面揀啲優秀嘅人先。
选手	奥运会上的选手们都竭尽全力，为了获得金牌而奋斗。<br><br>我細佬今年代表學校出比賽，做咗田徑隊嘅選手。
削弱	这场暴风雨严重削弱了海岸线的防御系统。<br><br>啲新政策削弱咗中小企嘅競爭力
学历	虽然学历不代表一切，但是它在求职过程中仍然起到重要作用。<br><br>你份學歷咁好，實搵到份好工㗎喇。
学位	为了实现他的梦想，他决定攻读计算机科学的学位。<br><br>佢攞咗個博士學位之後就去咗做研究員。
斩钉截铁	她斩钉截铁地拒绝了他的求婚。<br><br>佢斬釘截鐵咁答應我聽日一定會還錢俾我
投降	面对强敌，士兵们最终选择了投降。<br><br>見到咁多差人圍住，啲賊當場就扯白旗啦。
押金	为了租房，我付了一笔押金。<br><br>租樓要畀兩個月嘅按金俾業主。
招收	这家公司正在招收新的员工。<br><br>呢間公司最近喺度搵大學生做暑期實習生
珍贵	这块手表是爷爷留给我的珍贵遗产。<br><br>呢個係阿婆留低嘅相簿，好珍貴㗎，一定要好好保管。
对付	他很有办法对付各种困难。<br><br>我真係唔知點樣應付呢個麻煩嘅人
朝气蓬勃	他们是一群朝气蓬勃的年轻人，对未来充满希望。<br><br>睇吓班大學生咁有活力，朝早六點鐘就起身去跑步。
着迷	他着迷于探索未知的世界。<br><br>佢成日都咁迷上打機，連食飯都唔記得。
沼泽	这片沼泽地是许多珍稀鸟类的栖息地。<br><br>呢個沼澤啲蚊特別多，你記得要噴下驅蚊劑先好入去。
照样	虽然疫情影响很大，我们照样要保持积极乐观的态度。<br><br>佢發燒都照樣去返學
照耀	阳光照耀着田野，金黄的麦子在微风中轻轻摇曳。<br><br>太陽光照到成個海灘都金光閃閃
照应	他去国外学习期间，家人托我照应他一下。<br><br>你唔使擔心，有我喺度照住你㗎
嗅觉	他的嗅觉很灵敏，能闻到很远地方的花香。<br><br>聞到啲咁嘅味我嘅鼻好敏感㗎
虚假	他所说的话语全是虚假，目的是为了迷惑大家。<br><br>佢講嘅嘢全部都係假嘅，你千祈唔好信佢
虚伪	他的笑容是如此虚伪，让人忍不住怀疑他的真实目的。<br><br>佢個人好虛偽㗎，面前讚你背後就話你壞話
帐篷	我们今晚在湖边搭个帐篷露营。<br><br>我哋喺沙灘搭咗個帳篷過夜
折磨	夜深人静，他却难以入眠，被考试的焦虑折磨着。<br><br>啲蚊咬到我成晚瞓唔到覺，真係折磨
招投标	这座大桥的建造项目即将进行招投标，许多建筑公司都对此表示了强烈的兴趣。<br><br>佢哋公司啱啱開咗個招標會，想搵承辦商起新寫字樓。
侦探	这个侦探擅长破案，他总是能找到案件的线索。<br><br>我諗偵探呢份工好辛苦，日日都要跟人尾
珍稀	这种珍稀的植物只有在深山老林里才能找到。<br><br>呢種動物係一種稀有嘅品種，全世界得番幾百隻咋。
真相	真相最终会大白于天下。<br><br>我哋終於知道件事嘅真相
真挚	她对朋友的关心是真挚的。<br><br>佢對我嗰份感情好真摯，令我好感動
阵地	他们在激烈的战斗中顽强地守住了阵地。<br><br>我哋部隊要喺呢度死守住個陣地
震惊	听到这个消息，我感到无比震惊。<br><br>佢突然講咗呢個消息出嚟，我真係嚇到目瞪口呆
镇定	面对突发事件，她始终保持镇定，沉着应对。<br><br>你要冷靜啲先至搞得掂呢件事
镇压	政府决定对这场暴乱进行镇压。<br><br>警察用武力壓制示威嘅人，拉咗好多人返差館
折腾	他总是把自己的生活折腾得一团糟。<br><br>成晚瞓唔著，喺度扭嚟扭去，搞到好攰。
折腾	他整天折腾，就是不肯好好休息。<br><br>成晚瞓極唔著，喺度轉嚟轉去咁折騰。
争端	两国之间因为贸易争端的关系越来越紧张。<br><br>佢哋兩個成日都為咗啲小事爭論不休，搞到人人都好煩。
争夺	两支球队为了争夺冠军奖杯而展开了激烈的竞争。<br><br>班學生為咗爭奪獎學金，個個都拼晒命咁溫書。
蒸发	夏天，水从游泳池中蒸发，水面下降了不少。<br><br>咁熱嘅天氣，啲衫晾出去冇幾耐就乾晒
征服	人类对太空的征服是一个漫长的旅程。<br><br>打機三日三夜，佢終於征服咗呢隻咁難打嘅大佬級怪獸。
文献	为了写论文，我需要阅读大量相关文献。<br><br>佢寫論文嗰陣要搵好多參考資料嚟睇
文雅	他的举止文雅，令人印象深刻。<br><br>佢啲舉止文雅，講嘢都斯斯文文
文艺	她很喜欢文艺的电影和音乐。<br><br>我啲朋友成日去睇文化藝術表演，真係好有品味。
问世	这款全新的智能手机刚刚问世，就引起了极大的关注。<br><br>呢本書啱啱先面世冇幾耐
窝	两只小猫在温暖的阳光下，依偎在一起，互相取暖，看起来非常舒适。<br><br>啲雀仔喺棵樹上面整咗個竇
乌黑	他的头发乌黑浓密，在阳光下闪着光。<br><br>佢啲頭髮烏卒卒咁黑，好似啱啱染完咁
污蔑	他被污蔑为窃贼，尽管他什么都没做。<br><br>你唔好亂咁老屈人，冇證據就話人偷嘢真係好唔應該。
诬陷	他被诬陷偷了公司机密文件，感到十分委屈。<br><br>佢老屈我偷嘢，我真係好冤枉呀！
无比	他的勇气无比令人敬佩。<br><br>佢跳舞嘅技術真係其他人比唔上
无偿	为了帮助社区发展，他无偿地提供了很多建议。<br><br>呢個活動全部費用免晒，你唔使俾錢
舞蹈	她从小就热爱舞蹈，每天都会练习几个小时。<br><br>佢最近學咗跳舞，跳得幾好睇㗎
雪上加霜	本来生意就不景气，现在疫情又爆发了，真是雪上加霜。<br><br>佢老婆走咗冇幾耐，而家又俾人炒魷魚，真係雪上加霜
熏陶	在书香浓厚的环境中熏陶，我的文学素养得到了很大的提高。<br><br>喺屋企嘅良好氣氛薰陶之下，佢由細到大品德都好好。
学说	她学说英语已经两年了。<br><br>佢嗰套學術理論好複雜，一般人都好難明白。
循环	生活就像一个循环，不断地重复着，但也总会有新的变化。<br><br>呢首歌咁好聽，我想開單曲循環聽住先
巡逻	夜晚，警察在街上巡逻，确保居民的安全。<br><br>啲保安每日都會喺商場入面巡邏幾轉。
循序渐进	学习汉语需要循序渐进，不要急于求成。<br><br>要考入大學一定要跟住步驟慢慢嚟先得㗎
寻觅	他一直在森林里寻觅着失踪的孩子。<br><br>佢喺香港搵咗好耐先至搵到心水嘅工作
无动于衷	面对朋友的批评，他却无动于衷，仿佛什么也没听见。<br><br>睇到啲咁嘅新聞佢都冇乜反應，好似完全唔關佢事咁
无耻	他竟然为了利益出卖朋友，真是无耻之尤。<br><br>你咁樣做嘢真係無恥到極點！
无从	面对突如其来的难题，我们无从下手。<br><br>我對呢件事完全無從入手，唔知應該點做好。
无非	他所做的无非是想得到大家的认可。<br><br>佢日日嚟搵我，無非都係想借錢啫。
无精打采	考试前夕，他因为压力太大，显得无精打采。<br><br>佢今日成個人好頹廢，無晒精神咁樣
无可奉告	他对记者的提问，只说了三个字：无可奉告。<br><br>呢啲嘢我真係唔方便講俾你聽
侮辱	他用言语侮辱了她的智商，这让她感到非常生气。<br><br>你咁樣講嘢真係好侮辱人
无可奈何	面对如此困境，他只能无可奈何地接受现实。<br><br>阿媽病咗，我哋冇錢醫，只可以無可奈何噉睇住佢捱。
无赖	他被逼得走投无路，只能用无赖手段来骗取钱财。<br><br>佢成日呃人錢，真係無賴到冇得頂
无理取闹	明明知道自己错了，却还在无理取闹，真是让人头疼。<br><br>佢冇啲原因就嚟同我拗，真係無理取鬧！
无能为力	面对突如其来的疫情，我们只能尽量做好防护措施，对于经济的损失，我们也无能为力。<br><br>佢想幫我搬屋，但係實在冇辦法幫到手。
无穷无尽	浩瀚的宇宙充满了无穷无尽的奥秘，等待着我们去探索。<br><br>佢嗰啲廢話真係冇完冇了
回馈	用户对产品的回馈对开发人员非常宝贵。<br><br>我哋應該做下義工，回饋社會。
分泌	人体会分泌荷尔蒙来调节各种生理功能。<br><br>身體會自然噉滲出啲物質嚟保護自己㗎
反之（亦然）	如果天气晴朗，我们可以去爬山；反之，我们就待在家里。<br><br>佢好鍾意睇波，相反我就鍾意睇戲。
坟墓	古老的森林里隐藏着许多古老的坟墓。<br><br>我阿爺嘅墳地喺新界，每年清明我哋都會去掃墓。
风暴	这场台风将引发巨大的风暴，请做好准备。<br><br>琴日嗰陣狂風暴雨，連遮都冇用。
方针	为了应对气候变化，政府制定了一系列新的能源发展方针。<br><br>呢個新計劃嘅大方向係要幫助基層市民
范畴	他的研究领域涵盖了广泛的范畴，从历史到哲学，无所不包。<br><br>呢個學科太深奧，我完全唔識點做。
泛滥	这场大雨过后，河水泛滥，淹没了附近的村庄。<br><br>呢排電視劇太多，睇到眼都花埋
封锁	由于疫情的爆发，城市被封锁了。<br><br>警察為咗調查命案，琴晚封鎖咗成條街
锋利	这把刀的刀刃非常锋利，需要小心使用。<br><br>呢把剪刀咁鋒利，用嚟剪紙都好順手。
飞禽走兽	动物园里聚集了各种各样的飞禽走兽。<br><br>呢度山頭咁多動物，由天上飛嘅雀仔到地下行嘅野獸都有
风土人情	这次旅行让我们有机会体验当地的风土人情。<br><br>我最鍾意去日本睇下當地嘅生活習慣同文化
纺织	这座城市的郊外曾经是重要的纺织中心。<br><br>而家嘅紡織業都搬咗去大陸做
否决	政府否决了这项提案，因为它存在严重的法律问题。<br><br>班議員全部都唔肯通過呢個計劃。
福利	这家公司为员工提供各种福利，包括医疗保险和带薪休假。<br><br>呢間公司啲福利真係好好，有勤工獎同醫療保險添。
幅度	这次降价的幅度很大，吸引了许多顾客。<br><br>呢個動作嘅移動範圍唔可以太大㗎喎
分红	公司今年的利润很高，所以每个员工都可以拿到不少的分红。<br><br>你買咗呢間公司啲股票就每年都會收到分紅
分解	我把这个复杂的句子分解成几个简单的部分，这样更容易理解。<br><br>我哋將呢個問題分開嚟睇會更加容易明白啲
沸腾	热锅里的油已经沸腾，冒着阵阵白烟。<br><br>啲街坊投訴咁多,民怨真係沸騰啊
分裂	民族分裂会导致战争和混乱。<br><br>佢哋兩個嘅關係越嚟越差，最後完全分咗開。
分明	她分明在说谎，眼神都不敢直视我。<br><br>你分明想走人唔同我講啫！
分歧	关于是否应该继续这个项目，我们之间存在很大的分歧。<br><br>我哋兩個喺呢個問題上面有啲分歧，搞到開會都冇結果。
分散	敌人分散在森林里，很难找到他们。<br><br>我哋將啲人分開幾組，等大家唔會扎堆
粉末	这个蛋糕表面洒满了糖粉末。<br><br>啲藥要磨成粉先至好食得㗎。
服气	他的实力实在太强，我不得不服气。<br><br>我贏咗你咁多次，你依家總算服氣啩？
腐败	政府应该采取措施打击腐败。<br><br>啲高層咁樣貪錢，搞到間公司腐敗到冇得救
分量	这块蛋糕的分量太大了，我一个人吃不完。<br><br>你呢碗麵嘅份量幾大喎
副作用	长期服用这种药物可能会有副作用，所以要咨询医生。<br><br>我琴日食咗感冒藥，點知有副作用，成日都想瞓覺
风度	他举止优雅，充满了绅士风度。<br><br>佢對人好有風度，講嘢做嘢都係斯斯文文嘅樣
担保	银行担保了这笔贷款。<br><br>我以人格擔保佢冇偷錢
负担	我不能再独自承担所有工作了，需要一些帮助。<br><br>你養咁多隻狗，租樓又貴，呢個負擔真係唔細
覆盖	这片森林的树木覆盖了整座山。<br><br>呢張被仔咁大張，成張床都冚晒
附和	我附和他的观点，认为这场比赛应该延期。<br><br>佢咩都唔識，成日都係附和阿老闆講嘢
改良	农民们正在努力寻找改良土壤的方法。<br><br>我哋要諗下點樣改良呢個設計先至會更加實用
风气	近年来，在科技领域掀起了一股鼓励创新的风气。<br><br>依家啲後生仔成日打機，好多家長都擔心呢種社會風氣會影響佢哋讀書。
大不了	大不了我再找一份工作。<br><br>大不了我去第二間公司搵工啦。
得力	这个项目的成功得力于团队成员的共同努力。<br><br>我個新助手好幫到手，乜嘢都識做。
繁殖	细菌在温暖潮湿的环境中繁殖速度很快。<br><br>啲蟻咁快就繁殖，成間屋都係
挫折	经历过无数挫折后，他终于取得了成功。<br><br>我喺呢份工度遇到好多波折，差啲想辭職。
诽谤	网络上到处都是对他公司产品的诽谤言论。<br><br>佢係街度亂講人壞話，俾人告誹謗添。
就近	为了方便照顾家人，他们选择就近找工作。<br><br>我哋揾個就近嘅餐廳食飯啦，唔使行咁遠。
经纬	地球的经纬线将整个地球划分为无数个区域。<br><br>呢單嘢嘅來龍去脈我全部都知道晒。
大肆	媒体大肆报道了这场灾难。<br><br>呢排發生咗好多大事，唔知點算好。
迟缓	他的反应迟缓，没有及时抓住机会。<br><br>佢做嘢好遲緩，成日都要人催
竭尽全力	为了拿到奖学金，我竭尽全力地学习。<br><br>佢用盡全力去追尋自己嘅夢想
搭档	我正在寻找一位可靠的搭档，一起创业。<br><br>我同阿明係好多年嘅搭檔，拍戲都一齊拍
掠夺	海盗们在公海上掠夺商船，夺取财物。<br><br>班賊人夜晚走入村莊度掠奪晒啲村民嘅財物。
得天独厚	这座城市得天独厚，拥有优美的自然环境和丰富的文化资源。<br><br>香港得天獨厚，係個天然良港，先至可以發展到成為國際金融中心。
蹬	他费力地蹬着自行车上坡。<br><br>佢一下蹬腳踢開個波。
晋升	经过多年的努力，她终于晋升为部门经理。<br><br>佢今朝返公司開完會，老細話佢做得好好，過兩個月就可以升做高級主任
纠纷	邻居之间因为停车位产生了纠纷。<br><br>呢單勞資糾紛搞到成間公司都亂晒
督促	老师督促我们每天都要认真复习课本。<br><br>老闆成日都督促我哋做嘢快啲
孤立	这个国家在国际事务中一直处于孤立状态。<br><br>佢成日都被人排斥，好似畀人孤立咁
赌博	他沉迷于赌博，已经输掉了所有的积蓄。<br><br>佢成日去賭錢，搞到老婆都嬲到癲
兑换	在机场，你可以用外币兑换当地货币。<br><br>我要去銀行兌換啲外幣先至可以去旅行。
额外	为了完成任务，我额外花了几个小时加班。<br><br>佢哋話呢間餐廳收額外加一服務費㗎
恶化	国际局势正在恶化，令人担忧。<br><br>啲冷氣機老化咗冇乜維修過，運作越嚟越惡化。
发炎	他的手指因为感染而发炎了，医生建议他去看医生。<br><br>我呢排喉嚨發炎，連講嘢都好辛苦
符号	地图上的符号指示着通往宝藏的路。<br><br>呢個符號代表住愛同關懷嘅意思
否定	他断然否定我的计划。<br><br>我哋班主任否定咗呢個提議嘅可行性。
否认	他坚决否认自己参与了这场阴谋。<br><br>佢一直都死口死面唔肯認自己做過嘅嘢
服从	士兵必须服从指挥官的命令。<br><br>你要乖乖聽老師講嘅嘢
辅导	老师正在辅导学生学习数学。<br><br>佢哋聘請咗個輔導員幫啲學生處理情緒問題。
感激	我对你的帮助感到由衷的感激。<br><br>多謝你一直以嚟嘅幫手。
概括	这篇论文简洁明了地概括了当前人工智能领域的主要趋势。<br><br>你可唔可以概括啲講下重點呀？
感受	我感受到了这首诗的悲伤。<br><br>我完全感受到你嘅心情
雇佣	公司决定雇佣一位经验丰富的市场经理来拓展新业务。<br><br>我哋公司開緊兩個職位，想請人入嚟做嘢。
感想	看完这部电影，我有很多感想。<br><br>睇完呢套劇集，大家不如講吓自己嘅感想啦。
钢铁	这座桥是用钢铁建造的。<br><br>呢間工廠日日都要運送好多鐵支去地盤度。
干脆	与其犹豫不决，还不如干脆放弃。<br><br>你乾脆啲講清楚佢究竟想點啦
个别	虽然大部分学生都完成了作业，但个别学生迟交了。<br><br>啲學生要分開噉做功課先至知邊個係抄襲㗎
构成	构成这个项目的团队成员来自各个领域。<br><br>呢條片嘅劇組有成百幾人咁多
鼓舞	老师的鼓励的话语鼓舞了我们继续学习的决心。<br><br>佢嘅故事真係好勵志，鼓舞咗好多同路人。
风趣	他说话风趣幽默，总能逗笑大家。<br><br>呢個老師成日都講啲風趣嘅笑話，班學生都好鍾意聽佢講嘢。
筹备	我们正在筹备明年的公司周年庆典。<br><br>我哋而家開始籌備嚟緊嘅聖誕派對啦
贩卖	黑市贩卖假冒商品是违法的。<br><br>佢間公司主要係分銷日本嘅化妝品
肥沃	这片土地肥沃，非常适合种植粮食。<br><br>呢塊地嘅泥好肥，種乜都生得好快。
奉献	他把毕生的精力奉献给了医学事业。<br><br>佢成個人生都奉獻咗俾教育事業
分寸	他说话总是不注意分寸，经常得罪人。<br><br>你做人要識得分寸，唔係人人都鍾意你咁大嗌大叫㗎。
顿时	听到这个好消息，他顿时兴奋起来。<br><br>佢一講完個笑話，全場即刻靜晒。
咀嚼	他仔细地咀嚼着食物，品尝着食物的美味。<br><br>食麵要慢慢咀嚼，唔好咁快吞
举世闻名	泰姬陵是举世闻名的建筑奇迹。<br><br>香港嘅夜景全世界都識得㗎
举世瞩目	中国成功举办冬奥会，举世瞩目。<br><br>呢個新聞轟動全球，成個世界都睇實佢
举足轻重	他在公司的发展中扮演着举足轻重的角色。<br><br>喺呢間公司做咗咁多年，佢已經成為一個好有影響力嘅員工。
剧本	导演仔细地修改着剧本，希望能呈现一部更加精彩的作品。<br><br>我寫緊呢個劇本，希望可以搵到製作公司幫手拍成電影。
聚精会神	他聚精会神地阅读着那本难懂的书。<br><br>佢做功課嗰陣真係好專心
剧烈	剧烈的运动会让他感到非常疲倦。<br><br>琴日跑步跑得太勁，而家成身都好痛。
据悉	据悉，这座古城即将进行修复工作，预计将在两年内完工。<br><br>據知政府下個月會加大力度打擊違泊
附件	请您查看邮件附件，里面有详细的会议记录。<br><br>我已經將啲附件傳送咗畀你個電郵度啦。
腐蚀	权力会腐蚀人，绝对的权力会绝对地腐蚀人。<br><br>呢啲化學劑腐蝕性咁勁，一定要戴手套先好掂
逢	他逢人便夸赞自己的儿子。<br><br>我喺街度遇到個舊同學
决策	经过一番深思熟虑，他终于做出了明智的决策。<br><br>我哋公司新嘅決策可能會影響晒成個部門嘅運作
绝望	面对困难，我们不能轻易绝望。<br><br>睇住啲細路仔咁樣,我真係覺得好絕望。
觉悟	经过这次失败，他终于觉悟到自己的不足。<br><br>經過呢次失敗之後，佢終於有咗覺悟，知道要認真對待每一樣嘢。
军队	军队在边境巡逻，确保国家安全。<br><br>我個阿哥喺陸軍度做咗差唔多十年
开采	为了满足日益增长的能源需求，政府鼓励在该地区开采更多石油和天然气。<br><br>呢度以前係開採煤礦嘅地方，而家咩都冇剩低喇。
开除	公司因为工作效率低下，决定开除他。<br><br>佢成日請假唔返工，最後畀老細炒咗魷魚。
开阔	站在山顶上，视野开阔，可以看到远处连绵起伏的群山。<br><br>呢個地方好開闊，周圍都睇得好清楚
开朗	她性格开朗，总是能给周围的人带来快乐。<br><br>我覺得個新同事幾開朗，同邊個傾偈都咁開心
开明	她是一位开明的老师，总是鼓励学生自由思考。<br><br>阿媽好開明，俾我自己揀讀咩科都冇所謂。
开展	学校计划在暑假期间开展一系列的暑期活动。<br><br>警方今朝開始調查呢單案件
开支	这月的开支比往常高很多，可能是因为我们最近买了一些新的家具。<br><br>每個月嘅開支實在太大，使咗成萬蚊喎。
勘探	为了寻找新的矿藏，地质学家们正在勘探这个偏远的地区。<br><br>佢哋去年去新疆勘探石油，搵到唔少新油田。
反常	最近的气温反常，冬天竟然出现了高温天气。<br><br>佢最近嘅行為好反常，成日都悶悶不樂咁
匪徒	警方很快抓获了这些入室盗窃的匪徒。<br><br>琴日條村入面有兩個賊仔打劫咗間士多
敷衍	他敷衍了事地完成任务，结果导致了严重的错误。<br><br>你份功課咁敷衍，連基本嘢都冇做好，點攞分啊？
刊登	这家杂志将在下个月刊登一篇关于可持续发展的文章。<br><br>呢本雜誌已經停咗刊，以後都唔會再出
俘虏	敌军俘虏了许多士兵，但他们并没有放弃抵抗。<br><br>呢個明星嘅靚樣同把好聽嘅聲，真係俘虜咗成個亞洲嘅歌迷。
俯仰	他站在山顶，俯仰天地，心胸开阔。<br><br>呢啲事情講嚟講去都係一瞬間嘅事啫。
看待	我们应该用积极的态度看待人生中的挑战。<br><br>佢成日都當我係細路仔咁對待
沮丧	面对失败，他并没有沮丧，而是选择更加努力地学习。<br><br>做咩個樣咁沮喪啊，講嚟聽下啦
考古	考古学家在遗址中发现了古代文明的遗迹。<br><br>好多人鍾意喺網上考古，搵返以前啲舊嘢出嚟睇下。
客户	我们的公司正在努力提升客户满意度。<br><br>個客戶話要改晒份合約嘅內容，搞到我哋加班做
辐射	核武器爆炸会造成严重的辐射污染。<br><br>呢條路係由市中心向外伸展開嚟㗎
抚养	我的父母从小就抚养我长大，我很感谢他们。<br><br>佢一個人湊大三個仔女真係好叻
副	他担任公司副总裁一职。<br><br>佢做咗啲副業搵外快，每個月都有幾千蚊收入。
反倒	我本来以为他会很生气，反倒他表现得很冷静。<br><br>我本來以為佢會嬲，佢反而仲笑住同我講冇所謂
科目	大学里有许多科目，比如数学、物理和化学。<br><br>依個學期我揀咗三個科目嚟讀
颗粒	农民辛勤耕作，希望能颗粒归仓。<br><br>啲米跌咗好多細粒喺地下。
可观	这家新店的销量相当可观。<br><br>佢間舖頭生意好好，每個月賺到嘅錢都幾可觀。
可恶	他的行为实在可恶，让人无法忍受。<br><br>你睇吓佢幾惡揗揗咁望住人，好似想打交咁
可行	这个方案目前看来并不可行。<br><br>你個建議幾可行，我哋可以試下
考察	专家团队对项目的可行性进行了详细的考察。<br><br>我哋要去工廠實地調查先至知道情況係點
课题	今天我们要讨论的课题是环境保护。<br><br>我哋今日研究嘅係一個好重要嘅課題。
啃	他每天晚上都坐在书桌前，啃着书本，为考试做准备。<br><br>佢成日都惡啃嗰份功課，做咗成個禮拜都未搞掂。
恳切	他恳切地希望大家能支持他的计划。<br><br>呢個社工姐姐對我哋嘅態度好懇切，講嘢都好有誠意。
空洞	他的话语空洞无力，毫无说服力。<br><br>佢份工作報告咁空洞，睇完都唔知佢想講咩。
空前绝后	这部电影的特效堪称空前绝后，让观众叹为观止。<br><br>成個世界盃決賽真係好精彩，絕對係空前絕後嘅表現。
空虚	他的生活充满了空虚，因为他没有找到真正热爱的东西。<br><br>成日喺屋企打機都覺得好空虛
孔	这座寺庙有许多古老的石孔。<br><br>我個波波俾人扑穿咗個窿喎。
口气	他说话的口气很冲，让人很不舒服。<br><br>做完運動冇刷牙，個口氣臭到死
纲领	中国共产党的新时代中国特色社会主义思想是党的行动纲领。<br><br>我哋公司最緊要嘅原則就係以客為本。
甘心	他不甘心就这样放弃，决心要再试一次。<br><br>佢唔會甘心就咁輸畀人㗎
觉醒	在经历了多年的压迫之后，人们终于觉醒了，开始为自己的权利而斗争。<br><br>佢睇完呢本書之後終於醒覺，知道自己以前諗錯咗好多嘢。
开辟	他们开辟了这条新航线，让更多人有机会前往那片美丽的土地。<br><br>政府話今年會喺新界開條新路出嚟，等大家去大灣區方便啲。
开拓	经过几年的努力，他们终于开拓了新的市场。<br><br>我哋公司打算喺大灣區開拓新嘅市場
刊物	他订阅了许多文化刊物来丰富自己的知识。<br><br>呢本係我哋大學嘅學生刊物，每個月都會出一次。
堕落	他原本是个正直的人，却因为贪婪而堕落了。<br><br>佢啲生意蝕咗之後，成日喺屋企唔出街，慢慢咁墮落落去。
考验	这次旅行将考验我们的体力和耐力。<br><br>呢份工要日日加班，真係考驗人嘅耐性。
辅助	这款软件可以辅助你学习汉语。<br><br>我哋要搵多啲義工嚟幫手輔助長者
空隙	他利用课间休息的空隙去图书馆借了一本书。<br><br>架車同嗰條石壆之間仲有條罅，你慢慢泊啦。
磕	他磕了一块糖，不小心掉在地上了。<br><br>佢行路冇睇路撞親個頭落牆度
陡峭	这条山路十分陡峭，需要小心行走。<br><br>呢條行山徑咁斜，我行到氣都喘埋。
高峰	今年的旅游高峰期是十一黄金周。<br><br>而家啲商場高峰期，人多到行都行唔到
告辞	我向老师告辞后就回家了。<br><br>天都黑嘞，我要走先喇
告诫	老师告诫我们不要迟到。<br><br>我勸你唔好再咁樣做喇，會出事㗎。
高尚	他为了帮助他人而放弃了自己的利益，他的行为真是高尚。<br><br>佢呢個人好有品格，唔會做啲唔正路嘅嘢。
稿件	编辑在仔细检查稿件是否有任何错误。<br><br>我啱啱先寫咗份草稿，你幫我睇吓得唔得？
封建	封建社会中，人们等级森严，社会流动性很低。<br><br>佢老豆咁封建，唔畀佢拍拖添。
干扰	手机的铃声不停地干扰着我的思考。<br><br>啲人成日打嚟干擾我做嘢，好煩呀！
干涉	我们不应该干涉他人的私生活。<br><br>你咁樣成日過問人哋嘅私事，人哋會嬲㗎。
干预	政府不应该干预市场经济的正常运行。<br><br>你咩事都要過問，唔好咁多事啦！
感慨	看着这夕阳西下，我不禁感慨时光飞逝。<br><br>睇返以前嘅相冊，阿媽都忍唔住感慨萬分。
岗位	她已经在这家公司担任管理岗位五年了。<br><br>我哋公司開緊個新職位，月薪有成兩萬蚊
搁	我把书搁在桌上。<br><br>我諗呢件事暫時擱置咗先啦，等遲啲先至再睇過。
刻不容缓	全球气候变化问题刻不容缓，需要我们共同努力。<br><br>依個問題真係要即刻處理，唔可以拖到聽日先至做。
慷慨	他总是慷慨地帮助有需要的人。<br><br>佢好大方㗎，成日都請朋友食飯。
靠拢	随着战争的临近，敌对双方都开始靠拢军队准备战斗。<br><br>睇到隔離個公司生意咁好，佢哋都開始靠攏過嚟想合作。
附属	这座图书馆附属于附近的大学。<br><br>我哋個舞蹈學校係隸屬大學藝術中心嘅
扛	农民们扛着沉重的稻谷回家。<br><br>佢一個人揹起成個家庭嘅重擔
富裕	他的家庭非常富裕，但他仍然保持着节俭的生活方式。<br><br>阿明份工做到咁好，依家生活都幾富裕下
恐吓	黑帮试图恐吓他，让他说出秘密。<br><br>佢成日恐嚇人話要打爛我間鋪
恐惧	面对未知的未来，他心中充满了恐惧。<br><br>佢一諗起要考試就好驚，成個人瑟縮埋一舊
疙瘩	他心中一直有个疙瘩，无法释怀。<br><br>個膝頭打咗個大硬塊，痛到死
美观	这家咖啡厅的装修非常美观，让人感到舒适放松。<br><br>佢對窗簾揀得幾靚下，成個客廳都靚咗好多
美妙	这场音乐会真是美妙绝伦，让我陶醉其中。<br><br>呢個演唱會啲音樂真係好美妙
迷惑	他那模棱两可的回答让我更加迷惑。<br><br>佢俾個女仔迷惑咗，連自己做緊乜都唔知
门诊	今天下午，我要去医院的门诊看病。<br><br>今朝去睇門診，排隊排咗三個鐘頭。
萌芽	在互联网时代，新的商业模式不断萌芽。<br><br>呢個計劃開始發展嗰陣，我哋都唔知會咁成功。
弥漫	浓重的雾霾弥漫在城市上空，让人呼吸困难。<br><br>成間屋都充滿咗煙味，好難頂呀！
迷人	她的微笑非常迷人，让我无法移开目光。<br><br>呢個女仔笑起上嚟真係迷人
迷失	在陌生的城市里，很容易迷失方向。<br><br>啲後生仔喺社會打滾，好容易迷失方向。
迷信	他总是很迷信，每次出门前都会去看星座运势。<br><br>我表姐成日睇塔羅牌占卜，真係迷信到冇得頂
弥补	虽然他已经道歉了，但是他的道歉无法弥补他对我的伤害。<br><br>阿哥做錯咗嘢，而家想補返畀你。
密度	这座城市人口密度非常高，到处人山人海。<br><br>香港啲屋企密到好似人疊人咁
密封	为了防止食物变质，我们需要将罐头密封起来。<br><br>你幫我將個飯盒密封實啲，驚啲湯漏出嚟呀
免得	出门前一定要关好门窗，免得家里被盗。<br><br>你快啲搭的士返去啦，唔係遲到會被人投訴㗎
勉励	老师的勉励让我重拾信心，继续努力。<br><br>阿媽成日都會勸我要讀好書
勉强	他勉强答应了我的请求，但脸上却带着一丝不情愿的表情。<br><br>你個樣咁勉強，唔想做就講啦。
免疫	由于接种了疫苗，我们获得了对该病毒的免疫。<br><br>我個仔打咗流感針之後就免疫一段時間喇
灭亡	如果没有大家的共同努力，地球上的很多生物都将面临灭亡。<br><br>如果你咁樣搞落去，實會自取滅亡㗎
描绘	画家用生动的色彩描绘出一幅壮丽的夕阳景色。<br><br>佢好鍾意喺紙上面畫畫啲風景。
渺小	在浩瀚的宇宙中，人类显得多么渺小。<br><br>呢條魚仔咁渺小，連食都唔夠一啖。
蔑视	他总是蔑视那些比他弱小的人。<br><br>佢成日都睇唔起啲新入職嘅同事，搞到個辦公室冇人想同佢做嘢。
名次	他这次考试的成绩很好，获得了年级第一名的好名次。<br><br>阿仔次次考試都好緊張自己個名次
名额	报名参加这个比赛的人数很多，但名额有限。<br><br>依個課程淨係收二十個名額㗎咋。
名副其实	这家餐厅名副其实，味道真的很好。<br><br>呢間餐廳個服務真係好，完全冇呃人，同佢個五星級招牌咁講一樣
名誉	这位科学家凭借着多年的研究，赢得了世界范围内的名誉。<br><br>佢而家係我哋公司嘅名譽顧問，冇實際職務嘅。
敏捷	他以敏捷的动作躲过了对手的攻击。<br><br>佢打波身手好靈活，反應又快，真係叻仔
敏锐	他对市场变化有着敏锐的洞察力，因此总能把握商机。<br><br>佢嘅觸覺特別好，咩事都好快察覺到
命名	这座新桥将被命名为“和平桥”。<br><br>個仔出世之後，佢哋諗咗好耐先幫佢改個好名
猛烈	狂风猛烈地拍打着窗户。<br><br>今日個太陽咁猛烈，行路都頂唔順
能量	太阳能是可再生的清洁能源，可以提供源源不断的能量。<br><br>你做運動咗咁耐，身體能量應該充足啦。
磨合	新团队需要一段时间来磨合才能高效运作。<br><br>我同新同事仲要時間磨合，慢慢會好啲嘅。
模范	他被誉为行业的模范，其优秀的工作态度和精湛的技术深受同事们的尊敬。<br><br>佢係我哋班上面最好嘅榜樣，樣樣都做得好好。
抹杀	历史不应该被抹杀。<br><br>你唔可以咁樣抹煞人哋嘅努力同付出
模样	他长得很像他父亲，模样几乎一模一样。<br><br>佢個樣好似佢阿媽咁
目睹	我亲眼目睹了那场意外。<br><br>我親眼睇到佢偷嘢，所以即刻報警。
谋求	为了谋求更好的工作机会，他决定辞去现在这份工作。<br><br>佢諗緊點樣可以搵到份好工
纳闷儿	他一直纳闷儿为什么朋友不接他的电话。<br><br>咁多嘢諗到我頭都暈埋喇
耐用	这款背包很耐用，我已经用它三年了，还没坏。<br><br>呢部手機咁貴，起碼都要夠耐用先抵
沐浴	沐浴着温暖的阳光，她在花园里漫步。<br><br>我去沖個涼先啦。
难能可贵	在如今这个快节奏的社会，他仍然坚持着自己的理想，这难能可贵。<br><br>喺呢個時代仲有咁多人願意幫助人，真係好難得。
恼火	她因为考试考砸了，所以现在非常恼火。<br><br>佢成日搞到我火起，真係頂唔順。
摸索	他花了很长时间摸索出了这道难题的答案。<br><br>我阿媽摸索緊部新洗衣機點用
膜	科学家正在研究细胞膜的功能。<br><br>我眼睛前面好似有層膜咁，睇嘢都矇查查。
内幕	记者透露了一些关于这次政治事件的内幕。<br><br>有個朋友做記者，成日都知好多內幕。
纽扣儿	我穿衬衫时不小心掉了颗纽扣儿。<br><br>你條裙嘅衫鈕跌咗一粒喎
内涵	这幅画的内涵很深刻，需要仔细解读才能领会。<br><br>佢表面睇落普普通通，但係一同佢傾計就知佢真係好有內涵。
凝聚	我们大家应该共同努力，凝聚力量，战胜困难。<br><br>我哋要團結啲，將大家嘅力量拉埋一齊。
凝视	他凝视着她，眼中充满了悲伤和爱意。<br><br>佢成日都係咁望住個手機屏幕，好似痴咗線咁
捏	他紧张地捏着笔，试图在考试中写出完美的答案。<br><br>佢用手指搣咗我一啲肉好痛呀
莫名其妙	我感到莫名其妙，因为我根本没做过这件事。<br><br>佢無啦啦嬲到咁，真係莫名其妙
凝固	火山岩浆在流淌了一段时间后开始凝固。<br><br>啲豬油擺喺雪櫃度變咗硬㗎喇
宁肯	为了学习中文，我宁肯放弃打游戏。<br><br>我寧願瞓街都唔會返去嗰度住
拧	他用力地拧紧了水龙头，防止水浪费。<br><br>你做錯嘢就咪擰頭擰面啦，快啲認錯仲好啲。
拟定	为了迎接新学期，学校拟定了详细的教学计划。<br><br>我哋要決定落個計劃書先至搞得掂呢單嘢
扭转	他改变了策略，希望能扭转局面。<br><br>我哋要努力啲先至扭轉到依家呢個頹勢
浓厚	书店里弥漫着浓厚的墨香。<br><br>佢對打機真係好有興趣，成日都掛住玩。
趴	孩子们喜欢趴在窗户上看外面的风景。<br><br>佢攰到趴喺張梳化度瞓着咗
盘旋	直升机在山顶上盘旋，寻找着失踪的登山者。<br><br>個老鷹喺天空盤旋咗好耐
泡沫	肥皂水里的泡沫在阳光下闪耀着五彩的光芒。<br><br>你唔好買呢間公司嘅股票啦，聽講佢而家係泡沫嚟㗎喎。
排斥	他因为说话口音而被排斥在群体之外。<br><br>你咁樣擺架勢，梗係會畀人排斥㗎啦。
排除	排除一切干扰因素，我们才能集中精力完成任务。<br><br>我哋要搵方法排除呢個問題，唔可以再拖落去。
瘸	他因为车祸腿瘸了，走路很不方便。<br><br>佢隻腳受咗傷，而家行路跛跛哋
锦绣前程	经过多年的努力，她终于迎来了自己的锦绣前程。<br><br>希望你前程錦繡，事事順利！
没辙	面对他的坚持，我只能无奈地摇头，没辙了。<br><br>佢都冇釐搭霎，我真係冇計可諗喇。
屡次	他屡次警告我不要再犯同样的错误。<br><br>阿仔屢次遲到返學，老師都嬲到黑面
排放	工厂排放的废气严重污染了环境。<br><br>啲工廠排放咁多廢氣，空氣質素當然會差啦。
派别	政治界中有许多不同的派别，每个派别都主张不同的政策。<br><br>你睇下依家議會入面有咁多唔同派別，大家意見都唔同。
徘徊	她在繁华的街头徘徊，不知道该去哪里。<br><br>嗰個可疑嘅人成日喺便利店門口徘徊，睇嚟唔係咩好事
判决	法官最终判决被告有罪。<br><br>法官最後落咗個判決，判佢坐三年監。
攀登	为了达到山顶，他奋力攀登了几个小时。<br><br>我哋一齊爬上呢座山頂啦
抛弃	他为了追求梦想，毅然决然地抛弃了舒适安逸的生活。<br><br>佢媽咪一出世就拋棄咗佢
畔	湖畔风景如画，吸引了许多游客。<br><br>你企喺湖邊度影相真係幾靚下
培养	老师们在课堂上培养学生的学习兴趣。<br><br>要細路成材就要由細開始培養佢嘅好習慣
庞大	这个城市的规模庞大，人口众多。<br><br>呢間公司嘅規模大到嚇死人，每年請過千人入職。
配备	这艘潜水艇配备了最新的雷达系统。<br><br>佢間公司配備咗好多最新嘅電腦設備
配偶	他们结婚五年，现在有一个幸福的家庭，他们的配偶之间相敬如宾。<br><br>我老公今晚要返工，所以佢唔能夠同我一齊去睇戲。
配套	这家酒店的住宿套餐包括早餐、午餐和晚餐的配套服务。<br><br>間屋嘅配套設施幾齊全，有泳池健身室仲有商場添。
批发	这家批发市场供应各种各样的商品。<br><br>我哋公司做批發生意，成箱咁賣比商舖
烹饪	他喜欢烹饪各种各样的美食。<br><br>我好鍾意整嘢食，成日喺屋企煮餸煮飯。
批判	专家对这部电影提出了尖锐的批判。<br><br>佢成日批評人哋嘅理論，搞到冇乜人想同佢傾偈。
疲惫	长途旅行后，他感到十分疲惫。<br><br>做咗成日嘢，攰到冇晒力添。
皮革	他的新夹克是用优质皮革制成的。<br><br>我老豆間皮鋪專門賣啲皮製嘅銀包同手袋
偏见	他对外国人抱有偏见，总是认为他们都很奇怪。<br><br>佢成日都對新來嘅同事有偏見，咩都覺得人哋做得唔好。
偏偏	今天天气很好，偏偏我要加班。<br><br>我鍾意嗰間餐廳偏偏今日休息
片断	这部电影的片段在网上引起热议。<br><br>我哋每個人生命入面都有好多難忘嘅片段
片刻	她闭上眼睛，沉思了片刻。<br><br>等一陣先啦，我好快搞掂。
偏差	实验结果与预期值之间存在一定的偏差。<br><br>呢個計數好似同實際嘅數有啲偏差喎。
隔离	为了控制疫情的传播，政府对确诊病例进行了严格的隔离。<br><br>間屋住咗確診病人，依家要隔離十四日先至得出街。
格局	这个公司的格局很大，内部有很多部门，每个部门都井井有条。<br><br>佢哋新裝修嘅屋企格局幾好，好舒服嘅感覺。
个体	每个个体都拥有独特的价值和意义。<br><br>每個人都係獨立嘅個體，要學識為自己負責。
跟前	他走到老人跟前，轻轻地扶起他。<br><br>你成日都喺我面前轉來轉去，搞到我冇辦法專心做嘢。
考核	为了获得奖学金，学生们将接受严格的考核。<br><br>我哋要考核下佢嘅工作態度先至決定聘唔聘請佢
坑	这个坑很深，不要掉下去。<br><br>唔好掉垃圾落個坑度呀！
干旱	今年的夏天特别干旱，很多农民的庄稼都枯死了。<br><br>啲頭髮咁乾旱，睇嚟要搽多啲護髮素先得
格式	今天我要去参加一个婚礼，所以我必须穿着正式的格式。<br><br>你呢個相片要轉做 JPG 格式先可以擺上網㗎
根深蒂固	他的思想根深蒂固，很难改变。<br><br>佢嗰啲保守嘅諗法真係根深蒂固，點勸都唔肯改變。
根源	这个问题的根源在于我们对彼此缺乏了解。<br><br>要解決呢個問題，一定要搵出個源頭先得
高明	他的计谋实在是高明，让人防不胜防。<br><br>佢呢招真係好高明，乜都冇講就已經令人心服口服。
更新	这本杂志每个月都会更新一次。<br><br>呢個手機app要成日更新，麻煩到死
公道	法官应该主持公道，维护正义。<br><br>唔使擔心，我哋一定會主持公道，畀啲真相大家知。
恭敬	他对老师总是非常恭敬。<br><br>我唔敢同阿婆客氣，佢叫我即刻食飯我就乖乖哋坐低開餐啦。
功课	他总是把所有的功课都完成得很好。<br><br>你今日份中文功課做咗未呀？
攻克	经过多年的刻苦学习，他终于攻克了这道难题。<br><br>經過成個月嘅努力，終於搞掂咗呢條數學難題。
公民	每个公民都有责任维护社会秩序。<br><br>每個香港居民都有責任同權利去參與社會事務。
供给	粮食供给不足导致了饥荒。<br><br>我哋公司主要係供應電腦零件畀學校嘅
公婆	我和公婆住在一起，他们待我很好。<br><br>阿仔娶咗老婆之後就搬去同公婆住
公然	他们公然违反了协议，引起了国际社会的愤怒。<br><br>你唔好意思公開噉樣喺人哋面前講人閒話喎
公认	他是公认的行业专家，他的意见很有分量。<br><br>連啲唔識足球嘅人都知道美斯係勁到冇得頂
公式	根据这个公式，我们可以轻松计算出圆形的面积。<br><br>呢條數要用返標準方法嚟計先啱㗎。
公务	他今天因为公务出差到北京。<br><br>佢成日都公務纏身，冇時間同我哋出嚟食飯。
功效	这款新药的功效非常明显，使用后我的病症明显减轻了。<br><br>中醫話食雪耳對皮膚嘅功效好好
工艺品	这家商店里出售各种精美的手工艺品，吸引了许多游客前来选购。<br><br>呢啲工藝品都係人手整嘅，個個都好靚好精緻。
公正	法官应该公正地审判每一个被告。<br><br>身為裁判，你一定要公正處理每一個案件。
供不应求	现在市场上的智能手机供不应求，很多新款手机都需要提前预约才能买到。<br><br>而家啲新樓盤咁搶手，個個屋苑都供不應求。
共和国	中国是一个拥有悠久历史的社会主义共和国。<br><br>以前一九一二年到一九四九年嘅時候，中國叫做呢個名㗎。
共鸣	他的演讲充满了情感，引起了所有人的共鸣。<br><br>我睇完呢套電影都覺得好有共鳴
更正	老师要求我们更正试卷上的错误。<br><br>個報告有啲錯處，要改返先至啱
公证	律师建议他们将协议公证。<br><br>我哋要搵間公證行嚟幫手睇吓呢架車嘅損壞程度。
共计	这次旅行共计花费了五千元人民币。<br><br>加埋成個月嘅開支總共係一萬蚊
钩子	我把外套挂在了墙上的钩子上。<br><br>你間房掛勾咁少，啲衫褲都冇地方掛
公关	这家公司新聘请了一位公关经理，负责处理与媒体的关系。<br><br>我表妹做咗間酒店嘅公關主任，成日要應酬客人。
功劳	这次项目的成功，离不开所有团队成员的共同努力和功劳。<br><br>佢喺呢個計劃入面嘅功勞真係好大
固执	他固执己见，不肯听取别人的意见。<br><br>佢咁固執，人哋點講佢都唔肯改
拐杖	老人拄着拐杖慢慢地走着。<br><br>阿婆行路要靠枝盲公竹先企得穩陣啲。
构思	他花了几天时间才构思出一个完美的方案。<br><br>我個新故事仲未諗得好，要再諗下個構思點樣寫
关照	请你多关照我的朋友，他们刚来中国。<br><br>老闆咁有人脈，以後記住關照下我啊！
股东	公司目前正寻求新的股东来投资研发项目。<br><br>我細佬上個月買咗啲股票，而家都做咗股東喇
鼓动	他鼓动大家一起去参加游行。<br><br>琴日跑完步之後，我個心跳得好快
贯彻	我们要贯彻公司的新政策，提高工作效率。<br><br>我哋要貫徹自己嘅理想！
股份	这家公司的股份由三个创始人共同持有。<br><br>我阿叔啱啱買咗啲股票，而家係呢間公司嘅股東。
姑且	我们姑且先假设他说的都是真的。<br><br>我呢一刻都唔知點算好
古怪	他性格古怪，喜欢穿奇装异服。<br><br>佢個人好古怪，成日一個人喺度自言自語。
顾虑	他有很多顾虑，迟迟没有决定是否要投资这个项目。<br><br>我諗呢個決定都幾冒險，你有冇咩顧慮呀？
惯例	公司每年都会举办年会，这是公司惯例。<br><br>依個做法已經係我哋公司嘅習慣咁多年啦
固然	固然天气寒冷，但我们还是要去登山。<br><br>呢間餐廳固然好食，不過價錢貴咗啲。
顾问	这家公司聘请了一位经验丰富的市场顾问，为新产品的推广提供建议。<br><br>我哋公司聘請咗個新顧問幫手整理財務問題。
固有	这片土地拥有着丰富的固有文化。<br><br>我哋應該要保持香港固有嘅飲食文化，唔好俾人改變晒
管辖	这个地区由三个不同的省份管辖。<br><br>呢間公司啲分店全部由總部嚟管理㗎
光芒	夕阳的光芒染红了整片天空。<br><br>朝早啲太陽光芒照到成個客廳都好光
规范	为了确保项目顺利进行，我们需要严格遵守规范。<br><br>學校啲規則咁多，連着校服都要跟足規範。
规格	这家餐厅的菜品规格都很高，食材新鲜，味道也很好。<br><br>呢個零件唔合規格，要重新整過先得。
规划	政府已制定了一份详细的城市发展规划。<br><br>我哋要好好計劃下點樣裝修間屋先得
归还	图书馆提醒大家借阅的书籍请按时归还。<br><br>你借咗我本書咁耐，係時候還返俾我喇。
归根结底	归根结底，他还是放不下对家乡的思念。<br><br>講來講去，都係錢嘅問題啫。
贵族	在中世纪的欧洲，贵族拥有大量的土地和权力。<br><br>佢哋一家都係住喺山頂嘅權貴人士，平時都唔會同普通人打交道㗎。
国务院	国务院发布了一项新的环保政策。<br><br>中國嘅國務院頒布咗好多新政策嚟幫助中小企業渡過難關。
过度	过度使用手机会对眼睛造成伤害。<br><br>你咁樣捱夜打機，實會攰到冇晒命㗎
光辉	革命者的光辉事迹永远值得铭记。<br><br>今日嘅畢業禮見證咗佢哋讀書生涯最光輝嘅一刻。
归纳	他认真地阅读了所有材料，并试图从中归纳出解决问题的最佳方案。<br><br>你幫我將啲重點歸納一下，等我寫份報告出嚟。
规章	公司新制定的规章制度已经公布了。<br><br>我哋公司啲行規好嚴格，唔可以遲到㗎。
果断	面对突发状况，她果断地做出了决定。<br><br>你做事咁猶豫，你睇下佢幾果斷，一聽到有著數就即刻出手。
海滨	夕阳西下，海滨沙滩上人头攒动。<br><br>不如我哋週末去海邊行下散步啊？
棍棒	警察用棍棒驱散人群。<br><br>班差人見示威者衝過嚟，即刻攞起支警棍準備應付。
过滤	这款净水器可以过滤掉水中的杂质。<br><br>我裝咗個濾水器喺水喉度過濾啲自來水。
过失	由于他的过失，公司损失了大量的资金。<br><br>佢一時大意冇睇路，搞到撞親人
过问	这件事和你没有关系，请不要过问。<br><br>你咁鍾意插手人哋嘅事，唔好搞到人嬲咗先好。
过瘾	这场演唱会真是过瘾，每一首歌都让我热血沸腾。<br><br>打機打到天光，真係過癮！
过于	他的要求过于苛刻，没有人能够满足。<br><br>你咁樣過於擔心都冇用㗎
海拔	这座山的海拔超过了五千米。<br><br>呢座山嘅海拔有成三千幾米咁高
毫无	他毫无准备地参加了比赛，结果却取得了第一名。<br><br>佢對數學完全冇興趣㗎
航行	这艘船将航行到遥远的岛屿，寻找新的资源。<br><br>架郵輪喺太平洋航行咗成個月
航天	中国是世界上第一个将人送入太空的国家，它拥有强大的航天科技。<br><br>我個仔好鍾意睇火箭升空同飛機起飛嘅嘢
耗费	这个项目耗费了他们无数的时间和精力。<br><br>起呢間屋耗費咗成三百萬
寒暄	我们见面的时候总是先寒暄几句，才开始谈正事。<br><br>返到公司見到啲同事都係傾兩句天氣凍唔凍咁啫。
合并	为了提高效率，公司决定合并两个部门。<br><br>兩間公司合併之後，啲員工都擔心會裁員。
合乎	这个方案合乎我们的要求，我们可以继续讨论。<br><br>呢間餐廳啲嘢食都合乎食物安全標準
合身	这件外套很合身，穿起来很舒服。<br><br>呢件外套啱啱好合身，唔使改㗎喇。
宏观	从宏观角度来看，中国经济未来充满机遇。<br><br>要解決呢個問題，我哋要從高啲嘅角度去睇先至睇得清楚。
狠心	他对朋友狠心，竟然借了钱不还。<br><br>你做乜咁狠心唔俾佢返屋企食飯呀？
烘	一阵温暖的阳光烘烤着大地。<br><br>朝早烘個多士食好過食麵包
隔阂	长期不沟通，导致夫妻之间产生了隔阂。<br><br>佢哋兩個好耐冇傾偈，關係越嚟越疏離。
和睦	一家和睦的家庭是最宝贵的财富。<br><br>佢哋兩夫妻相處得好融洽
和气	大家要和气相处，才能让工作顺利进行。<br><br>佢哋一家人相處得好和睦，成日都見到佢哋笑笑口咁傾偈。
哄	妈妈哄着哭闹的宝宝，终于让他平静下来。<br><br>佢講完個笑話，成班人即刻笑到震天響。
后顾之忧	他终于决定辞职去创业，再也没有了后顾之忧。<br><br>佢而家搵到份好工，唔使再擔心屋企嘅開支。
后勤	为了顺利完成此次任务，后勤团队需做好物资调配和人员安排。<br><br>我哋要多謝啲喺後面支援嘅同事，佢哋嘅工作對前線好重要。
胡乱	他胡乱地翻找着文件，希望能找到那份合同。<br><br>你咁樣胡亂擺啲嘢，邊個搵得到㗎？
呼啸	狂风呼啸着穿过树林，吹落了满地的树叶。<br><br>架跑車喺公路上面尖聲叫喊咁飛過去。
湖泊	天山脚下，藏着一片宁静的湖泊，碧波荡漾，风景如画。<br><br>呢個湖靚到好似幅畫咁
互联网	互联网已经成为了现代人生活不可或缺的一部分。<br><br>我啲嘢要用wifi先至可以上網睇
苦尽甘来	经过多年的努力和奋斗，他终于苦尽甘来，取得了事业的成功。<br><br>捱咗咁耐，終於等到好消息喇。
偏僻	这家书店位于一条偏僻的小巷里，只有老顾客才知道它的位置。<br><br>呢間餐廳擺响咁偏僻嘅地方，實冇人行到嚟食飯㗎
渴望	她渴望能到国外留学。<br><br>我好渴望可以同屋企人一齊過新年。
空白	填写报名表时，请务必将所有空白处都填写完整。<br><br>做完場運動之後，我個腦一片空白，連行路都冇力。
耕地	农民们正在耕地准备播种。<br><br>我阿爺以前喺新界開荒地嚟種菜養家
跟踪	警方正在跟踪嫌疑人。<br><br>警方仲喺度查緊個賊嘅行蹤
古董	这家古玩店里摆满了各种各样的古董，吸引了许多收藏家前来。<br><br>我阿嫲收藏咗好多件古董，全部都係佢年輕嗰陣買返嚟嘅。
号召	政府号召民众积极参与疫情防控工作。<br><br>我哋一齊響應學校嘅號召，星期六返嚟做義工啦。
派遣	公司派遣他去参加国际会议。<br><br>我哋公司今日派咗幾個同事去開會
漂浮	气球在空中漂浮着。<br><br>片片落葉喺風度漂來漂去
飘扬	五星红旗在广场上飘扬。<br><br>條橫額俾風吹到飄揚
拼搏	为了实现梦想，我们必须拼搏到底。<br><br>佢哋成班人都好拼搏，日日加班做到夜晚十點幾
贫乏	由于缺乏资金，这个地区的文化活动非常贫乏。<br><br>佢屋企窮到連三餐飯都成問題
频繁	近年来，他频繁地往返于北京和上海两地，忙于公司的新项目。<br><br>佢呢排返工返得好密密，日日都見到佢喺公司
贫困	许多人正在努力克服贫困，争取更好的生活。<br><br>佢哋一家人窮到連三餐都成問題
频率	她每天早上都用手机看新闻，频率非常高。<br><br>呢間餐廳嘅客流量頻率好高，成日都排晒隊。
品尝	品尝了这道菜后，我才明白什么叫做色香味俱全。<br><br>呢個甜品咁靚，等我慢慢品嚐吓先啦。
品德	他品德高尚，值得我们学习。<br><br>依家啲細路品德好差，成日講粗口㗎喎。
品行	他品行端正，值得信赖。<br><br>佢份人品幾好嘅，從來都唔會講人壞話。
平凡	他的生活看似平凡，但他却怀揣着不平凡的梦想。<br><br>我哋一家都係好平凡嘅人，日日返工返學，過住普通生活。
评论	这部电影在网上获得了许多积极的评论。<br><br>你睇完套戲有咩意見呀？
含糊	他回答得很含糊，我并不能确定他真正的想法。<br><br>佢講嘢好含糊，我完全聽唔明佢想講乜嘢。
豪迈	他豪迈地举杯，向大家敬酒。<br><br>我好欣賞佢嗰種豪邁嘅性格，做嘢從來唔扭扭擰擰。
好客	这家餐厅以服务热情、好客著称，经常吸引很多回头客。<br><br>你都知我好好客，一定要請你返嚟食飯先得㗎。
合伙	他们决定合伙开一家咖啡店。<br><br>佢哋兩個諗住合夥開間餐廳
候选	三位候选人分别发表了他们的竞选演讲。<br><br>佢今年參加咗學生會會長嘅選舉，而家仲係候選人之一。
各抒己见	在这次讨论中，大家各抒己见，提出了很多有价值的建议。<br><br>大家都講到自己嘅意見，冇人肯讓步。
勾结	他们被指控勾结外国势力来破坏国家安全。<br><br>佢哋兩個暗地裏夾埋做壞事
杠杆	这家公司利用杠杆收购，成功获得了更大的市场份额。<br><br>用少少錢搵大錢，咁樣嘅槓桿效應好容易蝕到褲都冇
腹泻	最近吃了太多不卫生的路边摊，结果就腹泻了。<br><br>佢尋日食咗啲生蠔，今朝開始肚痾。
故障	汽车发动机突然出现了故障，导致它无法启动。<br><br>部冷氣機壞咗成個禮拜都仲未搵人整
辜负	我们不能辜负父母对我们的期望。<br><br>你咁樣做實在太令人失望啦
骨干	她是这个团队的骨干，很多重要的工作都靠她完成。<br><br>呢間公司嘅骨幹成員都係喺創業初期已經跟咗老闆做嘅人
口头	她没有留下任何书面证据，只留下了口头承诺。<br><br>佢成日講嘅嘢都係呃人㗎咋，唔好信佢把口。
平面	这幅画以平面形式展现了城市风景。<br><br>我哋要畫嘅嘢全部都係喺呢個平面上面㗎。
评估	老师会根据我们的表现来评估我们的学习成果。<br><br>我哋要睇下學生嘅程度先至識點教
枯燥	这份工作实在是太枯燥了，我每天都做着重复的事情。<br><br>呢份報告真係寫到好枯燥，睇到人想瞓覺。
灌溉	农民们辛勤地灌溉着田地，希望能获得丰收。<br><br>啲農夫要日日淋水畀啲菜先至會生得好
平坦	这条道路平坦易行。<br><br>呢度啲地好平坦，老人家行路都冇問題。
